Elapsed Time,Coverage,Exec/s,Avg Exec/s,Total Execs,MaxCov
0h 0m 0s,0,0,0,0,0
0h 0m 2s,8967,0,0,0,0
0h 0m 2s,9080,0,0,0,0
0h 0m 4s,11577,0,0,0,0
0h 0m 4s,11582,0,0,0,0
0h 0m 5s,11582,0,0,0,0
0h 0m 6s,11582,925,185,925,11582
0h 0m 7s,11585,0,148,925,11582
0h 0m 8s,11585,682,255,1607,11585
0h 0m 9s,11984,0,204,1607,11585
0h 0m 10s,11984,519,267,2126,11984
0h 0m 11s,11987,639,341,2765,11985
0h 0m 12s,11987,1320,537,4085,11987
0h 0m 13s,11988,2037,837,6122,11988
0h 0m 14s,11988,824,834,6946,11988
0h 0m 16s,11993,741,815,7687,11992
0h 0m 16s,11993,0,652,7687,11992
0h 0m 17s,12077,1246,771,8933,12077
0h 0m 18s,12081,1100,837,10033,12081
0h 0m 19s,12081,1908,1051,11941,12081
0h 0m 20s,12081,0,841,11941,12081
0h 0m 21s,12093,2332,1139,14273,12093
0h 0m 23s,12096,652,1042,14925,12093
0h 0m 24s,12106,1069,1047,15994,12106
0h 0m 24s,12162,378,913,16372,12106
0h 0m 25s,12164,436,818,16808,12162
0h 0m 26s,12164,560,766,17368,12164
0h 0m 27s,12164,642,741,18010,12164
0h 0m 28s,12165,1296,852,19306,12165
0h 0m 30s,12352,1186,919,20492,12352
0h 0m 30s,12352,0,735,20492,12352
0h 0m 31s,12352,581,704,21073,12352
0h 0m 32s,12365,578,679,21651,12365
0h 0m 33s,12365,2106,964,23757,12365
0h 0m 34s,12365,0,771,23757,12365
0h 0m 35s,12366,1885,994,25642,12366
0h 0m 37s,12406,1034,1002,26676,12366
0h 0m 37s,12407,499,901,27175,12406
0h 0m 38s,12407,2681,1257,29856,12407
0h 0m 39s,12410,644,1134,30500,12407
0h 0m 40s,12410,630,1033,31130,12410
0h 0m 41s,12410,0,826,31130,12410
0h 0m 43s,12411,534,768,31664,12410
0h 0m 43s,12757,0,614,31664,12410
0h 0m 44s,12768,0,491,31664,12410
0h 0m 45s,12768,1435,680,33099,12768
0h 0m 46s,12768,584,661,33683,12768
0h 0m 48s,12770,1948,918,35631,12770
0h 0m 49s,12770,1409,1016,37040,12770
0h 0m 49s,12770,708,954,37748,12770
0h 0m 51s,12770,1278,1019,39026,12770
0h 0m 51s,12770,889,993,39915,12770
0h 0m 53s,12819,2049,1204,41964,12819
0h 0m 53s,12819,0,963,41964,12819
0h 0m 54s,12819,620,894,42584,12819
0h 0m 55s,12827,0,715,42584,12819
0h 0m 56s,12827,0,572,42584,12819
0h 0m 57s,12829,726,603,43310,12829
0h 0m 58s,12832,2315,945,45625,12832
0h 0m 59s,12832,1513,1059,47138,12832
0h 1m 0s,12832,682,984,47820,12832
0h 1m 1s,12832,1350,1057,49170,12832
0h 1m 2s,12832,0,846,49170,12832
0h 1m 4s,12866,0,677,49170,12832
0h 1m 5s,12866,559,653,49729,12866
0h 1m 5s,12866,1821,887,51550,12866
0h 1m 7s,12995,807,871,52357,12868
0h 1m 8s,12995,1923,1081,54280,12995
0h 1m 8s,12996,0,865,54280,12995
0h 1m 10s,12999,2308,1154,56588,12999
0h 1m 10s,12999,0,923,56588,12999
0h 1m 11s,13000,0,738,56588,12999
0h 1m 13s,13008,1514,893,58102,13000
0h 1m 13s,13008,2204,1155,60306,13008
0h 1m 14s,13008,0,924,60306,13008
0h 1m 15s,13017,0,739,60306,13008
0h 1m 16s,13017,1638,919,61944,13017
0h 1m 17s,13017,1101,955,63045,13017
0h 1m 19s,13017,1621,1088,64666,13017
0h 1m 20s,13028,1714,1213,66380,13028
0h 1m 20s,13031,480,1066,66860,13031
0h 1m 22s,13031,1482,1149,68342,13031
0h 1m 22s,13031,399,999,68741,13031
0h 1m 24s,13035,1190,1037,69931,13031
0h 1m 25s,13035,3757,1581,73688,13035
0h 1m 25s,13035,0,1265,73688,13035
0h 1m 26s,13035,0,1012,73688,13035
0h 1m 27s,13039,1207,1051,74895,13039
0h 1m 29s,13040,1508,1142,76403,13039
0h 1m 30s,13042,745,1063,77148,13042
0h 1m 30s,13042,0,850,77148,13042
0h 1m 31s,13042,1358,952,78506,13042
0h 1m 33s,13042,711,904,79217,13042
0h 1m 34s,13042,770,877,79987,13042
0h 1m 35s,13042,3724,1446,83711,13042
0h 1m 35s,13042,0,1157,83711,13042
0h 1m 36s,13044,1470,1220,85181,13044
0h 1m 37s,13047,1377,1251,86558,13047
0h 1m 38s,13047,2978,1596,89536,13047
0h 1m 39s,13047,1108,1498,90644,13047
0h 1m 40s,13047,736,1346,91380,13047
0h 1m 41s,13049,0,1077,91380,13047
0h 1m 43s,13126,686,999,92066,13050
0h 1m 43s,13126,707,941,92773,13126
0h 1m 44s,13126,597,872,93370,13126
0h 1m 45s,13126,663,830,94033,13126
0h 1m 46s,13126,2185,1101,96218,13126
0h 1m 47s,13176,0,881,96218,13126
0h 1m 49s,13182,491,803,96709,13181
0h 1m 49s,13184,550,752,97259,13182
0h 1m 50s,13184,0,602,97259,13182
0h 1m 52s,13185,1999,881,99258,13185
0h 1m 52s,13186,579,821,99837,13186
0h 1m 53s,13192,0,657,99837,13186
0h 1m 55s,13192,2911,1108,102748,13192
0h 1m 55s,13192,0,886,102748,13192
0h 1m 57s,13195,1865,1082,104613,13195
0h 1m 57s,13195,0,866,104613,13195
0h 1m 59s,13195,1634,1020,106247,13195
0h 1m 59s,13195,1165,1049,107412,13195
0h 2m 1s,13195,839,1007,108251,13195
0h 2m 1s,13195,592,924,108843,13195
0h 2m 3s,13195,1352,1010,110195,13195
0h 2m 3s,13195,1826,1173,112021,13195
0h 2m 4s,13206,522,1043,112543,13195
0h 2m 6s,13211,1835,1201,114378,13211
0h 2m 6s,13213,1809,1323,116187,13213
0h 2m 7s,13213,739,1206,116926,13213
0h 2m 8s,13213,1177,1200,118103,13213
0h 2m 10s,13218,1923,1345,120026,13218
0h 2m 10s,13218,0,1076,120026,13218
0h 2m 11s,13218,0,861,120026,13218
0h 2m 13s,13218,1248,938,121274,13218
0h 2m 14s,13218,1295,1009,122569,13218
0h 2m 14s,13218,1798,1167,124367,13218
0h 2m 15s,13218,1176,1169,125543,13218
0h 2m 16s,13219,1104,1156,126647,13219
0h 2m 17s,13219,0,925,126647,13219
0h 2m 18s,13219,780,896,127427,13219
0h 2m 20s,13219,811,879,128238,13219
0h 2m 21s,13219,1396,982,129634,13219
0h 2m 22s,13219,1461,1078,131095,13219
0h 2m 22s,13219,554,973,131649,13219
0h 2m 23s,13219,677,914,132326,13219
0h 2m 25s,13219,2598,1251,134924,13219
0h 2m 25s,13219,531,1107,135455,13219
0h 2m 26s,13219,1192,1124,136647,13219
0h 2m 28s,13231,2860,1471,139507,13231
0h 2m 28s,13231,0,1177,139507,13231
0h 2m 29s,13231,1024,1146,140531,13231
0h 2m 30s,13232,0,917,140531,13231
0h 2m 31s,13232,739,881,141270,13232
0h 2m 33s,13232,2180,1141,143450,13232
0h 2m 34s,13289,727,1058,144177,13289
0h 2m 35s,13289,1580,1162,145757,13289
0h 2m 35s,13289,676,1065,146433,13289
0h 2m 36s,13289,648,982,147081,13289
0h 2m 37s,13289,615,909,147696,13289
0h 2m 38s,13289,616,850,148312,13289
0h 2m 40s,13302,1253,931,149565,13301
0h 2m 40s,13302,0,745,149565,13301
0h 2m 42s,13302,1493,895,151058,13302
0h 2m 43s,13302,1316,979,152374,13302
0h 2m 43s,13302,580,899,152954,13302
0h 2m 45s,13302,2508,1221,155462,13302
0h 2m 46s,13302,1063,1189,156525,13302
0h 2m 46s,13302,1802,1312,158327,13302
0h 2m 48s,13302,1441,1338,159768,13302
0h 2m 48s,13302,0,1070,159768,13302
0h 2m 49s,13303,2023,1261,161791,13303
0h 2m 50s,13303,718,1152,162509,13303
0h 2m 51s,13303,1133,1148,163642,13303
0h 2m 52s,13303,1906,1300,165548,13303
0h 2m 53s,13303,0,1040,165548,13303
0h 2m 54s,13303,1028,1038,166576,13303
0h 2m 55s,13303,0,830,166576,13303
0h 2m 57s,13303,478,760,167054,13303
0h 2m 57s,13303,1147,837,168201,13303
0h 2m 58s,13303,1492,968,169693,13303
0h 2m 59s,13316,1419,1058,171112,13303
0h 3m 0s,13316,1296,1106,172408,13316
0h 3m 1s,13316,0,885,172408,13316
0h 3m 2s,13319,3329,1374,175737,13319
0h 3m 3s,13320,1590,1417,177327,13320
0h 3m 4s,13320,2149,1563,179476,13320
0h 3m 5s,13320,621,1375,180097,13320
0h 3m 6s,13320,2738,1648,182835,13320
0h 3m 7s,13327,669,1452,183504,13320
0h 3m 8s,13327,778,1317,184282,13327
0h 3m 9s,13327,1306,1315,185588,13327
0h 3m 10s,13327,612,1174,186200,13327
0h 3m 11s,13327,1379,1215,187579,13327
0h 3m 12s,13327,853,1143,188432,13327
0h 3m 13s,13327,2024,1319,190456,13327
0h 3m 14s,13327,762,1208,191218,13327
0h 3m 15s,13327,0,966,191218,13327
0h 3m 16s,13329,1371,1047,192589,13329
0h 3m 17s,13329,1417,1121,194006,13329
0h 3m 18s,13329,0,897,194006,13329
0h 3m 19s,13329,1168,951,195174,13329
0h 3m 20s,13341,1937,1148,197111,13341
0h 3m 21s,13341,627,1044,197738,13341
0h 3m 22s,13341,1213,1078,198951,13341
0h 3m 23s,13341,0,862,198951,13341
0h 3m 24s,13341,703,830,199654,13341
0h 3m 26s,13359,1865,1037,201519,13359
0h 3m 27s,13359,2811,1392,204330,13359
0h 3m 28s,13361,1836,1481,206166,13361
0h 3m 29s,13364,615,1308,206781,13361
0h 3m 29s,13364,688,1184,207469,13364
0h 3m 30s,13364,0,947,207469,13364
0h 3m 32s,13364,1958,1149,209427,13364
0h 3m 33s,13364,1616,1242,211043,13364
0h 3m 33s,13364,0,994,211043,13364
0h 3m 35s,13364,1114,1018,212157,13364
0h 3m 36s,13364,725,959,212882,13364
0h 3m 36s,13364,0,767,212882,13364
0h 3m 38s,13365,745,763,213627,13365
0h 3m 39s,13365,1092,829,214719,13365
0h 3m 40s,13366,776,818,215495,13366
0h 3m 41s,13366,566,768,216061,13366
0h 3m 42s,13366,1126,840,217187,13366
0h 3m 42s,13366,0,672,217187,13366
0h 3m 43s,13366,461,630,217648,13366
0h 3m 45s,13366,2556,1015,220204,13366
0h 3m 45s,13366,719,956,220923,13366
0h 3m 46s,13366,2043,1173,222966,13366
0h 3m 47s,13366,649,1068,223615,13366
0h 3m 49s,13378,3173,1489,226788,13378
0h 3m 50s,13379,0,1191,226788,13378
0h 3m 51s,13379,633,1079,227421,13379
0h 3m 52s,13379,1334,1130,228755,13379
0h 3m 53s,13379,732,1050,229487,13379
0h 3m 54s,13379,3090,1458,232577,13379
0h 3m 55s,13379,2232,1613,234809,13379
0h 3m 56s,13379,1075,1505,235884,13379
0h 3m 57s,13379,0,1204,235884,13379
0h 3m 58s,13379,1219,1207,237103,13379
0h 3m 59s,13379,1841,1334,238944,13379
0h 4m 0s,13379,0,1067,238944,13379
0h 4m 1s,13379,545,963,239489,13379
0h 4m 2s,13379,573,885,240062,13379
0h 4m 3s,13381,957,899,241019,13381
0h 4m 4s,13389,1298,979,242317,13389
0h 4m 5s,13389,1408,1065,243725,13389
0h 4m 6s,13389,1134,1079,244859,13389
0h 4m 7s,13389,0,863,244859,13389
0h 4m 8s,13389,1267,944,246126,13389
0h 4m 9s,13390,840,923,246966,13389
0h 4m 10s,13390,609,860,247575,13390
0h 4m 11s,13390,1043,897,248618,13390
0h 4m 12s,13390,2376,1193,250994,13390
0h 4m 13s,13390,2116,1378,253110,13390
0h 4m 14s,13390,1050,1312,254160,13390
0h 4m 15s,13391,1240,1298,255400,13391
0h 4m 16s,13391,0,1038,255400,13391
0h 4m 17s,13391,1284,1087,256684,13391
0h 4m 18s,13391,0,870,256684,13391
0h 4m 19s,13391,1050,906,257734,13391
0h 4m 20s,13391,1887,1102,259621,13391
0h 4m 21s,13392,1482,1178,261103,13392
0h 4m 22s,13392,679,1078,261782,13392
0h 4m 23s,13392,1392,1141,263174,13392
0h 4m 25s,13401,2571,1427,265745,13401
0h 4m 25s,13474,627,1267,266372,13474
0h 4m 26s,13535,1976,1409,268348,13535
0h 4m 27s,13535,0,1127,268348,13535
0h 4m 28s,13535,925,1087,269273,13535
0h 4m 29s,13535,1507,1171,270780,13535
0h 4m 31s,13535,1664,1270,272444,13535
0h 4m 31s,13535,1335,1283,273779,13535
0h 4m 32s,13535,0,1026,273779,13535
0h 4m 33s,13535,2191,1259,275970,13535
0h 4m 34s,13535,1381,1283,277351,13535
0h 4m 35s,13535,854,1197,278205,13535
0h 4m 36s,13535,0,958,278205,13535
0h 4m 37s,13535,1188,1004,279393,13535
0h 4m 38s,13535,0,803,279393,13535
0h 4m 39s,13535,2033,1049,281426,13535
0h 4m 40s,13535,532,946,281958,13535
0h 4m 41s,13535,3867,1530,285825,13535
0h 4m 42s,13535,747,1373,286572,13535
0h 4m 43s,13535,522,1203,287094,13535
0h 4m 44s,13535,1402,1243,288496,13535
0h 4m 45s,13535,2258,1446,290754,13535
0h 4m 46s,13536,1694,1496,292448,13536
0h 4m 47s,13536,1760,1549,294208,13536
0h 4m 48s,13536,0,1239,294208,13536
0h 4m 49s,13536,1202,1232,295410,13536
0h 4m 50s,13536,500,1086,295910,13536
0h 4m 51s,13540,0,869,295910,13536
0h 4m 52s,13540,1094,914,297004,13540
0h 4m 54s,13540,1914,1114,298918,13540
0h 4m 54s,13540,0,891,298918,13540
0h 4m 55s,13540,570,827,299488,13540
0h 4m 56s,13540,0,662,299488,13540
0h 4m 57s,13540,775,685,300263,13540
0h 4m 58s,13540,0,548,300263,13540
0h 5m 0s,13540,1733,785,301996,13540
0h 5m 1s,13540,1888,1006,303884,13540
0h 5m 2s,13540,2133,1231,306017,13540
0h 5m 2s,13540,1213,1227,307230,13540
0h 5m 3s,13540,659,1113,307889,13540
0h 5m 4s,13540,463,983,308352,13540
0h 5m 6s,13542,2705,1327,311057,13540
0h 5m 7s,13542,2245,1511,313302,13542
0h 5m 7s,13542,1259,1461,314561,13542
0h 5m 8s,13542,675,1304,315236,13542
0h 5m 10s,13542,3225,1688,318461,13542
0h 5m 11s,13542,1480,1646,319941,13542
0h 5m 11s,13542,1407,1598,321348,13542
0h 5m 12s,13542,2136,1706,323484,13542
0h 5m 13s,13542,0,1365,323484,13542
0h 5m 14s,13542,581,1208,324065,13542
0h 5m 15s,13542,771,1121,324836,13542
0h 5m 16s,13542,772,1051,325608,13542
0h 5m 17s,13542,0,841,325608,13542
0h 5m 18s,13542,1901,1053,327509,13542
0h 5m 19s,13542,1503,1143,329012,13542
0h 5m 20s,14056,943,1103,329955,14056
0h 5m 21s,14056,1367,1156,331322,14056
0h 5m 22s,14056,0,925,331322,14056
0h 5m 23s,14056,1137,967,332459,14056
0h 5m 25s,14056,2338,1241,334797,14056
0h 5m 26s,14059,998,1192,335795,14059
0h 5m 27s,14059,1838,1321,337633,14059
0h 5m 27s,14062,0,1057,337633,14059
0h 5m 28s,14062,1162,1078,338795,14062
0h 5m 29s,14062,662,995,339457,14062
0h 5m 30s,14062,0,796,339457,14062
0h 5m 31s,14062,0,637,339457,14062
0h 5m 32s,14062,598,629,340055,14062
0h 5m 33s,14062,1970,897,342025,14062
0h 5m 34s,14062,1333,984,343358,14062
0h 5m 36s,14064,1873,1162,345231,14062
0h 5m 36s,14064,526,1035,345757,14064
0h 5m 37s,14064,547,937,346304,14064
0h 5m 38s,14064,1385,1027,347689,14064
0h 5m 40s,14064,1685,1159,349374,14064
0h 5m 40s,14064,0,927,349374,14064
0h 5m 42s,14064,879,917,350253,14064
0h 5m 42s,14064,1029,939,351282,14064
0h 5m 43s,14064,642,880,351924,14064
0h 5m 44s,14064,560,816,352484,14064
0h 5m 46s,14064,1842,1021,354326,14064
0h 5m 47s,14064,2055,1228,356381,14064
0h 5m 47s,14064,1451,1273,357832,14064
0h 5m 48s,14064,0,1018,357832,14064
0h 5m 49s,14064,564,927,358396,14064
0h 5m 50s,14064,1094,960,359490,14064
0h 5m 51s,14064,1251,1018,360741,14064
0h 5m 52s,14064,3202,1455,363943,14064
0h 5m 53s,14079,0,1164,363943,14064
0h 5m 54s,14080,479,1027,364422,14080
0h 5m 55s,14080,1997,1221,366419,14080
0h 5m 56s,14087,1469,1271,367888,14080
0h 5m 57s,14100,0,1017,367888,14080
0h 5m 58s,14100,1971,1208,369859,14100
0h 5m 59s,14100,2002,1367,371861,14100
0h 6m 0s,14100,455,1185,372316,14100
0h 6m 1s,14100,686,1085,373002,14100
0h 6m 2s,14100,518,972,373520,14100
0h 6m 3s,14100,1477,1073,374997,14100
0h 6m 4s,14100,2148,1288,377145,14100
0h 6m 5s,14100,648,1160,377793,14100
0h 6m 7s,14101,590,1046,378383,14101
0h 6m 7s,14101,497,936,378880,14101
0h 6m 9s,14101,2160,1181,381040,14101
0h 6m 9s,14101,0,945,381040,14101
0h 6m 10s,14101,0,756,381040,14101
0h 6m 11s,14101,631,731,381671,14101
0h 6m 13s,14101,3092,1203,384763,14101
0h 6m 13s,14101,0,962,384763,14101
0h 6m 15s,14101,1424,1054,386187,14101
0h 6m 15s,14107,0,843,386187,14101
0h 6m 16s,14107,2090,1092,388277,14107
0h 6m 18s,14107,2792,1432,391069,14107
0h 6m 18s,14107,1197,1385,392266,14107
0h 6m 19s,14107,621,1232,392887,14107
0h 6m 20s,14107,1574,1300,394461,14107
0h 6m 21s,14107,0,1040,394461,14107
0h 6m 22s,14107,1982,1228,396443,14107
0h 6m 23s,14142,0,982,396443,14107
0h 6m 24s,14142,3270,1440,399713,14142
0h 6m 25s,14142,0,1152,399713,14142
0h 6m 26s,14142,653,1052,400366,14142
0h 6m 27s,14142,0,842,400366,14142
0h 6m 28s,14142,741,822,401107,14142
0h 6m 29s,14142,1540,966,402647,14142
0h 6m 30s,14142,771,927,403418,14142
0h 6m 31s,14142,644,870,404062,14142
0h 6m 32s,14142,1395,975,405457,14142
0h 6m 33s,14142,1095,999,406552,14142
0h 6m 34s,14142,1981,1195,408533,14142
0h 6m 35s,14142,1505,1257,410038,14142
0h 6m 36s,14142,0,1006,410038,14142
0h 6m 37s,14143,2511,1307,412549,14143
0h 6m 38s,14143,739,1193,413288,14143
0h 6m 39s,14143,2227,1400,415515,14143
0h 6m 40s,14143,719,1264,416234,14143
0h 6m 41s,14143,2662,1544,418896,14143
0h 6m 42s,14143,1410,1517,420306,14143
0h 6m 43s,14148,482,1310,420788,14143
0h 6m 44s,14148,511,1150,421299,14148
0h 6m 45s,14148,1258,1172,422557,14148
0h 6m 46s,14148,1088,1155,423645,14148
0h 6m 47s,14148,1322,1188,424967,14148
0h 6m 48s,14148,0,950,424967,14148
0h 6m 49s,14148,0,760,424967,14148
0h 6m 51s,14150,1738,956,426705,14150
0h 6m 52s,14150,978,960,427683,14150
0h 6m 53s,14150,1011,970,428694,14150
0h 6m 54s,14150,1532,1082,430226,14150
0h 6m 55s,14150,2051,1276,432277,14150
0h 6m 55s,14150,1206,1262,433483,14150
0h 6m 57s,14150,1920,1394,435403,14150
0h 6m 57s,14150,896,1294,436299,14150
0h 6m 58s,14150,2084,1452,438383,14150
0h 6m 59s,14150,650,1292,439033,14150
0h 7m 0s,14150,2312,1496,441345,14150
0h 7m 2s,14151,735,1344,442080,14150
0h 7m 2s,14151,0,1075,442080,14150
0h 7m 4s,14151,1386,1137,443466,14151
0h 7m 4s,14151,545,1019,444011,14151
0h 7m 6s,14151,713,958,444724,14151
0h 7m 6s,14151,0,766,444724,14151
0h 7m 7s,14151,530,719,445254,14151
0h 7m 9s,14151,2173,1010,447427,14151
0h 7m 10s,14151,1282,1064,448709,14151
0h 7m 11s,14151,2685,1388,451394,14151
0h 7m 11s,14151,0,1110,451394,14151
0h 7m 12s,14151,0,888,451394,14151
0h 7m 13s,14151,1080,926,452474,14151
0h 7m 14s,14151,2078,1156,454552,14151
0h 7m 15s,14151,1125,1150,455677,14151
0h 7m 16s,14151,1634,1247,457311,14151
0h 7m 17s,14151,533,1104,457844,14151
0h 7m 19s,14152,575,998,458419,14152
0h 7m 20s,14152,1211,1041,459630,14152
0h 7m 21s,14152,1729,1179,461359,14152
0h 7m 21s,14152,0,943,461359,14152
0h 7m 23s,14152,2005,1155,463364,14152
0h 7m 24s,14152,1166,1157,464530,14152
0h 7m 25s,14152,1360,1198,465890,14152
0h 7m 25s,14152,0,958,465890,14152
0h 7m 26s,14152,0,766,465890,14152
0h 7m 27s,14152,1362,885,467252,14152
0h 7m 29s,14152,1387,985,468639,14152
0h 7m 29s,14152,2246,1237,470885,14152
0h 7m 30s,14152,753,1140,471638,14152
0h 7m 31s,14152,2062,1324,473700,14152
0h 7m 32s,14152,722,1204,474422,14152
0h 7m 34s,14152,501,1063,474923,14152
0h 7m 34s,14152,972,1045,475895,14152
0h 7m 35s,14152,1275,1091,477170,14152
0h 7m 36s,14152,708,1014,477878,14152
0h 7m 37s,14152,0,811,477878,14152
0h 7m 38s,14152,602,769,478480,14152
0h 7m 39s,14152,3503,1316,481983,14152
0h 7m 41s,14152,613,1175,482596,14152
0h 7m 42s,14172,542,1048,483138,14152
0h 7m 43s,14172,727,984,483865,14172
0h 7m 44s,14172,0,787,483865,14172
0h 7m 45s,14172,1986,1027,485851,14172
0h 7m 46s,14172,848,991,486699,14172
0h 7m 47s,14172,1493,1091,488192,14172
0h 7m 48s,14172,0,873,488192,14172
0h 7m 49s,14172,437,786,488629,14172
0h 7m 50s,14172,659,761,489288,14172
0h 7m 51s,14172,412,691,489700,14172
0h 7m 52s,14172,2327,1018,492027,14172
0h 7m 53s,14172,842,983,492869,14172
0h 7m 54s,14172,609,908,493478,14172
0h 7m 55s,14172,2394,1205,495872,14172
0h 7m 56s,14172,0,964,495872,14172
0h 7m 57s,14172,756,922,496628,14172
0h 7m 58s,14172,2166,1171,498794,14172
0h 7m 59s,14172,1692,1275,500486,14172
0h 8m 0s,14172,715,1163,501201,14172
0h 8m 1s,14172,646,1060,501847,14172
0h 8m 2s,14172,0,848,501847,14172
0h 8m 3s,14172,711,821,502558,14172
0h 8m 4s,14172,451,747,503009,14172
0h 8m 5s,14172,0,598,503009,14172
0h 8m 6s,14172,0,478,503009,14172
0h 8m 7s,14172,747,532,503756,14172
0h 8m 8s,14172,2023,830,505779,14172
0h 8m 9s,14172,0,664,505779,14172
0h 8m 10s,14172,605,652,506384,14172
0h 8m 11s,14172,2934,1108,509318,14172
0h 8m 12s,14172,581,1003,509899,14172
0h 8m 13s,14172,1202,1043,511101,14172
0h 8m 14s,14172,1078,1050,512179,14172
0h 8m 15s,14172,591,958,512770,14172
0h 8m 16s,14172,0,766,512770,14172
0h 8m 17s,14172,510,715,513280,14172
0h 8m 18s,14172,3264,1225,516544,14172
0h 8m 19s,14172,765,1133,517309,14172
0h 8m 20s,14172,0,906,517309,14172
0h 8m 21s,14172,559,837,517868,14172
0h 8m 22s,14172,1666,1003,519534,14172
0h 8m 23s,14172,724,947,520258,14172
0h 8m 24s,14172,2006,1159,522264,14172
0h 8m 25s,14172,1252,1178,523516,14172
0h 8m 26s,14172,806,1104,524322,14172
0h 8m 27s,14173,0,883,524322,14172
0h 8m 28s,14173,1323,971,525645,14173
0h 8m 29s,14173,1447,1066,527092,14173
0h 8m 30s,14173,2704,1394,529796,14173
0h 8m 31s,14173,656,1246,530452,14173
0h 8m 32s,14173,654,1128,531106,14173
0h 8m 33s,14173,0,902,531106,14173
0h 8m 34s,14173,2384,1198,533490,14173
0h 8m 35s,14173,1332,1225,534822,14173
0h 8m 36s,14173,501,1080,535323,14173
0h 8m 37s,14173,1249,1114,536572,14173
0h 8m 38s,14173,2554,1402,539126,14173
0h 8m 39s,14173,0,1122,539126,14173
0h 8m 40s,14173,1973,1292,541099,14173
0h 8m 41s,14173,1242,1282,542341,14173
0h 8m 43s,14177,1616,1349,543957,14177
0h 8m 43s,14177,746,1228,544703,14177
0h 8m 44s,14177,1856,1354,546559,14177
0h 8m 45s,14177,1751,1433,548310,14177
0h 8m 46s,14177,0,1146,548310,14177
0h 8m 48s,14177,521,1021,548831,14177
0h 8m 48s,14177,694,956,549525,14177
0h 8m 49s,14177,1432,1051,550957,14177
0h 8m 50s,14177,1334,1108,552291,14177
0h 8m 51s,14177,0,886,552291,14177
0h 8m 52s,14177,1234,956,553525,14177
0h 8m 53s,14177,0,765,553525,14177
0h 8m 54s,14177,1949,1002,555474,14177
0h 8m 55s,14177,1389,1079,556863,14177
0h 8m 56s,14177,2381,1339,559244,14177
0h 8m 57s,14177,1464,1364,560708,14177
0h 8m 58s,14177,0,1091,560708,14177
0h 8m 59s,14177,1426,1158,562134,14177
0h 9m 0s,14177,797,1086,562931,14177
0h 9m 1s,14177,1697,1208,564628,14177
0h 9m 3s,14177,1645,1295,566273,14177
0h 9m 3s,14177,1346,1305,567619,14177
0h 9m 4s,14177,504,1145,568123,14177
0h 9m 5s,14177,1300,1176,569423,14177
0h 9m 6s,14177,1266,1194,570689,14177
0h 9m 7s,14177,0,955,570689,14177
0h 9m 8s,14177,1134,991,571823,14177
0h 9m 9s,14177,1973,1187,573796,14177
0h 9m 10s,14177,542,1058,574338,14177
0h 9m 11s,14177,0,846,574338,14177
0h 9m 12s,14177,1109,899,575447,14177
0h 9m 13s,14177,688,857,576135,14177
0h 9m 14s,14179,0,686,576135,14177
0h 9m 15s,14179,1255,800,577390,14179
0h 9m 16s,14179,732,786,578122,14179
0h 9m 17s,14179,1383,905,579505,14179
0h 9m 18s,14179,1468,1018,580973,14179
0h 9m 19s,14179,837,982,581810,14179
0h 9m 20s,14179,0,786,581810,14179
0h 9m 21s,14182,599,749,582409,14179
0h 9m 22s,14182,678,735,583087,14182
0h 9m 23s,14182,1599,908,584686,14182
0h 9m 24s,14182,875,901,585561,14182
0h 9m 25s,14182,0,721,585561,14182
0h 9m 26s,14182,508,678,586069,14182
0h 9m 27s,14182,743,691,586812,14182
0h 9m 28s,14185,0,553,586812,14182
0h 9m 30s,14185,2037,850,588849,14185
0h 9m 30s,14185,646,809,589495,14185
0h 9m 32s,14185,795,806,590290,14185
0h 9m 32s,14185,597,764,590887,14185
0h 9m 34s,14185,513,714,591400,14185
0h 9m 34s,14185,694,710,592094,14185
0h 9m 35s,14185,1061,780,593155,14185
0h 9m 36s,14185,649,754,593804,14185
0h 9m 37s,14185,525,708,594329,14185
0h 9m 38s,14185,2000,966,596329,14185
0h 9m 39s,14190,742,921,597071,14190
0h 9m 41s,14190,1441,1025,598512,14190
0h 9m 41s,14190,550,930,599062,14190
0h 9m 42s,14190,0,744,599062,14190
0h 9m 43s,14190,1950,985,601012,14190
0h 9m 44s,14190,946,977,601958,14190
0h 9m 45s,14190,743,930,602701,14190
0h 9m 46s,14190,0,744,602701,14190
0h 9m 47s,14190,1386,872,604087,14190
0h 9m 48s,14190,2568,1211,606655,14190
0h 9m 49s,14190,754,1120,607409,14190
0h 9m 50s,14190,0,896,607409,14190
0h 9m 51s,14190,894,896,608303,14190
0h 9m 53s,14192,2382,1193,610685,14192
0h 9m 53s,14192,814,1117,611499,14192
0h 9m 55s,14192,2523,1398,614022,14192
0h 9m 55s,14192,1222,1363,615244,14192
0h 9m 56s,14192,723,1235,615967,14192
0h 9m 58s,14192,1934,1375,617901,14192
0h 9m 58s,14192,594,1219,618495,14192
0h 9m 59s,14192,415,1058,618910,14192
0h 10m 0s,14192,1318,1110,620228,14192
0h 10m 1s,14192,680,1024,620908,14192
0h 10m 3s,14192,2858,1391,623766,14192
0h 10m 3s,14192,374,1188,624140,14192
0h 10m 4s,14192,595,1069,624735,14192
0h 10m 5s,14192,1983,1252,626718,14192
0h 10m 6s,14192,1286,1259,628004,14192
0h 10m 7s,14192,1969,1401,629973,14192
0h 10m 8s,14192,0,1121,629973,14192
0h 10m 10s,14195,2535,1404,632508,14195
0h 10m 10s,14195,659,1255,633167,14195
0h 10m 11s,14195,0,1004,633167,14195
0h 10m 12s,14195,1915,1186,635082,14195
0h 10m 14s,14198,2060,1361,637142,14198
0h 10m 14s,14198,0,1089,637142,14198
0h 10m 16s,14198,1770,1225,638912,14198
0h 10m 16s,14198,389,1058,639301,14198
0h 10m 18s,14198,2005,1247,641306,14198
0h 10m 18s,14198,0,998,641306,14198
0h 10m 20s,14200,1787,1156,643093,14200
0h 10m 20s,14200,476,1020,643569,14200
0h 10m 21s,14200,2743,1365,646312,14200
0h 10m 22s,14200,0,1092,646312,14200
0h 10m 23s,14200,1253,1124,647565,14200
0h 10m 24s,14200,1836,1266,649401,14200
0h 10m 25s,14200,1168,1246,650569,14200
0h 10m 26s,14200,627,1122,651196,14200
0h 10m 27s,14200,1832,1264,653028,14200
0h 10m 28s,14200,556,1122,653584,14200
0h 10m 29s,14200,769,1051,654353,14200
0h 10m 31s,14201,730,987,655083,14201
0h 10m 32s,14201,1302,1050,656385,14201
0h 10m 33s,14201,508,942,656893,14201
0h 10m 34s,14201,1438,1041,658331,14201
0h 10m 35s,14201,1824,1198,660155,14201
0h 10m 35s,14201,1039,1166,661194,14201
0h 10m 37s,14201,3158,1564,664352,14201
0h 10m 37s,14201,0,1251,664352,14201
0h 10m 38s,14201,1863,1373,666215,14201
0h 10m 39s,14201,1429,1384,667644,14201
0h 10m 40s,14201,2152,1538,669796,14201
0h 10m 41s,14201,593,1349,670389,14201
0h 10m 42s,14201,0,1079,670389,14201
0h 10m 43s,14201,1249,1113,671638,14201
0h 10m 44s,14202,1913,1273,673551,14202
0h 10m 45s,14202,785,1175,674336,14202
0h 10m 46s,14202,1873,1315,676209,14202
0h 10m 47s,14202,768,1206,676977,14202
0h 10m 48s,14202,1158,1196,678135,14202
0h 10m 49s,14202,727,1102,678862,14202
0h 10m 50s,14202,0,882,678862,14202
0h 10m 52s,14202,1861,1078,680723,14202
0h 10m 53s,14202,2157,1294,682880,14202
0h 10m 54s,14202,878,1211,683758,14202
0h 10m 55s,14202,1243,1217,685001,14202
0h 10m 56s,14202,1826,1339,686827,14202
0h 10m 57s,14202,1910,1453,688737,14202
0h 10m 58s,14202,914,1345,689651,14202
0h 10m 59s,14202,522,1180,690173,14202
0h 11m 0s,14202,3204,1585,693377,14202
0h 11m 1s,14202,1608,1590,694985,14202
0h 11m 2s,14202,1159,1504,696144,14202
0h 11m 3s,14202,578,1319,696722,14202
0h 11m 4s,14206,729,1201,697451,14202
0h 11m 5s,14206,0,961,697451,14202
0h 11m 6s,14208,1269,1023,698720,14208
0h 11m 7s,14208,280,874,699000,14208
0h 11m 8s,14208,1284,956,700284,14208
0h 11m 9s,14208,1438,1052,701722,14208
0h 11m 10s,14208,0,842,701722,14208
0h 11m 11s,14208,1031,880,702753,14208
0h 11m 12s,14208,0,704,702753,14208
0h 11m 13s,14208,1276,818,704029,14208
0h 11m 14s,14208,2273,1109,706302,14208
0h 11m 15s,14209,525,992,706827,14208
0h 11m 16s,14209,1968,1187,708795,14209
0h 11m 17s,14209,0,950,708795,14209
0h 11m 19s,14209,2939,1348,711734,14209
0h 11m 20s,14209,1133,1305,712867,14209
0h 11m 21s,14209,2733,1591,715600,14209
0h 11m 21s,14209,1143,1501,716743,14209
0h 11m 22s,14209,708,1342,717451,14209
0h 11m 23s,14209,1165,1307,718616,14209
0h 11m 24s,14209,0,1046,718616,14209
0h 11m 25s,14209,502,937,719118,14209
0h 11m 26s,14209,807,911,719925,14209
0h 11m 27s,14211,765,882,720690,14211
0h 11m 28s,14211,487,803,721177,14211
0h 11m 29s,14211,595,761,721772,14211
0h 11m 31s,14211,1224,854,722996,14211
0h 11m 31s,14211,1560,995,724556,14211
0h 11m 32s,14211,0,796,724556,14211
0h 11m 33s,14211,1195,876,725751,14211
0h 11m 34s,14211,720,845,726471,14211
0h 11m 35s,14211,1441,964,727912,14211
0h 11m 36s,14215,1146,1000,729058,14211
0h 11m 37s,14215,2495,1299,731553,14215
0h 11m 38s,14215,603,1160,732156,14215
0h 11m 39s,14215,1193,1167,733349,14215
0h 11m 40s,14215,0,934,733349,14215
0h 11m 41s,14217,2021,1151,735370,14217
0h 11m 42s,14217,632,1047,736002,14217
0h 11m 43s,14217,2840,1406,738842,14217
0h 11m 44s,14217,568,1238,739410,14217
0h 11m 45s,14217,854,1161,740264,14217
0h 11m 46s,14217,1157,1160,741421,14217
0h 11m 47s,14217,1552,1238,742973,14217
0h 11m 48s,14217,0,990,742973,14217
0h 11m 49s,14217,602,912,743575,14217
0h 11m 51s,14218,2058,1141,745633,14218
0h 11m 51s,14218,0,913,745633,14218
0h 11m 52s,14218,650,860,746283,14218
0h 11m 54s,14218,1250,938,747533,14218
0h 11m 54s,14218,0,750,747533,14218
0h 11m 55s,14218,1057,811,748590,14218
0h 11m 56s,14218,2254,1100,750844,14218
0h 11m 57s,14218,1112,1102,751956,14218
0h 11m 58s,14218,2268,1335,754224,14218
0h 11m 59s,14218,772,1222,754996,14218
0h 12m 0s,14218,1471,1272,756467,14218
0h 12m 1s,14218,0,1018,756467,14218
0h 12m 2s,14218,1491,1113,757958,14218
0h 12m 3s,14218,687,1028,758645,14218
0h 12m 4s,14218,0,822,758645,14218
0h 12m 5s,14218,1440,946,760085,14218
0h 12m 6s,14218,1448,1046,761533,14218
0h 12m 7s,14218,612,959,762145,14218
0h 12m 8s,14218,383,844,762528,14218
0h 12m 9s,14218,1136,902,763664,14218
0h 12m 10s,14220,488,819,764152,14218
0h 12m 12s,14220,1841,1023,765993,14220
0h 12m 12s,14220,1125,1043,767118,14220
0h 12m 13s,14220,719,978,767837,14220
0h 12m 14s,14220,0,782,767837,14220
0h 12m 15s,14220,795,785,768632,14220
0h 12m 16s,14220,634,755,769266,14220
0h 12m 17s,14220,0,604,769266,14220
0h 12m 18s,14220,452,574,769718,14220
0h 12m 19s,14220,1970,853,771688,14220
0h 12m 21s,14220,2674,1217,774362,14220
0h 12m 21s,14220,1478,1269,775840,14220
0h 12m 22s,14220,0,1015,775840,14220
0h 12m 23s,14228,1291,1070,777131,14228
0h 12m 24s,14228,2618,1380,779749,14228
0h 12m 25s,14228,1335,1371,781084,14228
0h 12m 26s,14228,0,1097,781084,14228
0h 12m 27s,14238,1032,1084,782116,14238
0h 12m 28s,14238,0,867,782116,14238
0h 12m 29s,14238,0,694,782116,14238
0h 12m 30s,14238,1737,903,783853,14238
0h 12m 31s,14238,3015,1325,786868,14238
0h 12m 32s,14238,739,1208,787607,14238
0h 12m 33s,14238,1273,1221,788880,14238
0h 12m 34s,14238,504,1078,789384,14238
0h 12m 35s,14238,1481,1159,790865,14238
0h 12m 36s,14238,0,927,790865,14238
0h 12m 37s,14238,1813,1104,792678,14238
0h 12m 38s,14238,0,883,792678,14238
0h 12m 39s,14238,2104,1127,794782,14238
0h 12m 40s,14238,2603,1422,797385,14238
0h 12m 41s,14238,1371,1412,798756,14238
0h 12m 42s,14238,0,1130,798756,14238
0h 12m 43s,14238,1506,1205,800262,14238
0h 12m 44s,14238,0,964,800262,14238
0h 12m 45s,14238,542,880,800804,14238
0h 12m 46s,14238,564,817,801368,14238
0h 12m 47s,14238,810,816,802178,14238
0h 12m 48s,14238,773,807,802951,14238
0h 12m 49s,14238,1344,914,804295,14238
0h 12m 50s,14238,706,872,805001,14238
0h 12m 51s,14238,0,698,805001,14238
0h 12m 52s,14238,2613,1081,807614,14238
0h 12m 53s,14238,749,1015,808363,14238
0h 12m 54s,14238,609,934,808972,14238
0h 12m 55s,14238,1844,1116,810816,14238
0h 12m 56s,14238,1302,1153,812118,14238
0h 12m 57s,14238,0,922,812118,14238
0h 12m 58s,14238,1865,1111,813983,14238
0h 12m 59s,14238,0,889,813983,14238
0h 13m 0s,14238,1891,1089,815874,14238
0h 13m 1s,14238,0,871,815874,14238
0h 13m 2s,14238,0,697,815874,14238
0h 13m 4s,14238,1207,799,817081,14238
0h 13m 4s,14238,1109,861,818190,14238
0h 13m 5s,14238,2060,1101,820250,14238
0h 13m 6s,14238,0,881,820250,14238
0h 13m 7s,14238,592,823,820842,14238
0h 13m 8s,14238,563,771,821405,14238
0h 13m 9s,14238,0,617,821405,14238
0h 13m 10s,14238,973,688,822378,14238
0h 13m 11s,14238,1589,868,823967,14238
0h 13m 12s,14238,1701,1035,825668,14238
0h 13m 13s,14238,690,966,826358,14238
0h 13m 14s,14238,868,946,827226,14238
0h 13m 15s,14238,2274,1212,829500,14238
0h 13m 16s,14238,1097,1189,830597,14238
0h 13m 17s,14238,529,1057,831126,14238
0h 13m 18s,14238,1931,1232,833057,14238
0h 13m 19s,14238,978,1181,834035,14238
0h 13m 20s,14238,763,1097,834798,14238
0h 13m 21s,14238,619,1001,835417,14238
0h 13m 22s,14238,1977,1196,837394,14238
0h 13m 23s,14238,525,1062,837919,14238
0h 13m 24s,14238,671,984,838590,14238
0h 13m 25s,14238,1768,1141,840358,14238
0h 13m 26s,14238,1476,1208,841834,14238
0h 13m 27s,14238,847,1136,842681,14238
0h 13m 28s,14239,865,1082,843546,14239
0h 13m 29s,14239,569,979,844115,14239
0h 13m 30s,14239,1763,1136,845878,14239
0h 13m 31s,14239,0,909,845878,14239
0h 13m 32s,14239,1259,979,847137,14239
0h 13m 33s,14239,611,905,847748,14239
0h 13m 34s,14239,453,815,848201,14239
0h 13m 35s,14239,1274,907,849475,14239
0h 13m 36s,14239,640,854,850115,14239
0h 13m 37s,14239,0,683,850115,14239
0h 13m 38s,14239,2909,1128,853024,14239
0h 13m 39s,14239,612,1025,853636,14239
0h 13m 40s,14239,541,928,854177,14239
0h 13m 41s,14239,1262,995,855439,14239
0h 13m 42s,14239,1170,1030,856609,14239
0h 13m 43s,14239,749,974,857358,14239
0h 13m 44s,14239,1255,1030,858613,14239
0h 13m 45s,14239,679,960,859292,14239
0h 13m 46s,14239,1285,1025,860577,14239
0h 13m 47s,14239,1548,1130,862125,14239
0h 13m 48s,14239,0,904,862125,14239
0h 13m 49s,14239,2309,1185,864434,14239
0h 13m 50s,14239,583,1065,865017,14239
0h 13m 51s,14239,2010,1254,867027,14239
0h 13m 52s,14239,1699,1343,868726,14239
0h 13m 53s,14239,482,1171,869208,14239
0h 13m 54s,14240,667,1070,869875,14240
0h 13m 55s,14240,2570,1370,872445,14240
0h 13m 56s,14240,0,1096,872445,14240
0h 13m 57s,14240,1991,1275,874436,14240
0h 13m 58s,14240,1293,1279,875729,14240
0h 13m 59s,14240,657,1155,876386,14240
0h 14m 0s,14240,1151,1154,877537,14240
0h 14m 1s,14240,1212,1166,878749,14240
0h 14m 2s,14241,1916,1316,880665,14241
0h 14m 3s,14241,668,1186,881333,14241
0h 14m 4s,14241,686,1086,882019,14241
0h 14m 5s,14241,809,1031,882828,14241
0h 14m 6s,14241,0,825,882828,14241
0h 14m 7s,14241,0,660,882828,14241
0h 14m 8s,14241,3138,1156,885966,14241
0h 14m 9s,14241,0,925,885966,14241
0h 14m 10s,14242,1378,1016,887344,14242
0h 14m 11s,14242,0,813,887344,14242
0h 14m 12s,14242,2519,1154,889863,14242
0h 14m 14s,14242,0,923,889863,14242
0h 14m 15s,14242,0,738,889863,14242
0h 14m 16s,14242,2179,1026,892042,14242
0h 14m 17s,14242,533,927,892575,14242
0h 14m 18s,14242,2848,1311,895423,14242
0h 14m 19s,14242,472,1143,895895,14242
0h 14m 20s,14242,1001,1115,896896,14242
0h 14m 21s,14242,2539,1400,899435,14242
0h 14m 22s,14242,677,1255,900112,14242
0h 14m 23s,14242,1827,1369,901939,14242
0h 14m 24s,14242,0,1095,901939,14242
0h 14m 25s,14242,1133,1103,903072,14242
0h 14m 26s,14242,0,882,903072,14242
0h 14m 27s,14242,2016,1109,905088,14242
0h 14m 28s,14242,1378,1163,906466,14242
0h 14m 29s,14242,1594,1249,908060,14242
0h 14m 30s,14242,692,1138,908752,14242
0h 14m 31s,14242,1868,1284,910620,14242
0h 14m 32s,14242,2055,1438,912675,14242
0h 14m 33s,14242,0,1150,912675,14242
0h 14m 34s,14242,563,1033,913238,14242
0h 14m 35s,14242,0,826,913238,14242
0h 14m 36s,14242,1383,937,914621,14242
0h 14m 37s,14242,437,837,915058,14242
0h 14m 38s,14242,1459,961,916517,14242
0h 14m 39s,14242,2540,1277,919057,14242
0h 14m 40s,14242,1772,1376,920829,14242
0h 14m 41s,14242,367,1174,921196,14242
0h 14m 42s,14242,1215,1182,922411,14242
0h 14m 43s,14242,1239,1193,923650,14242
0h 14m 44s,14242,528,1060,924178,14242
0h 14m 45s,14242,2682,1384,926860,14242
0h 14m 46s,14243,583,1224,927443,14243
0h 14m 48s,14243,1974,1374,929417,14243
0h 14m 48s,14243,566,1212,929983,14243
0h 14m 49s,14243,0,970,929983,14243
0h 14m 50s,14319,2342,1244,932325,14244
0h 14m 51s,14319,1153,1226,933478,14319
0h 14m 52s,14319,0,981,933478,14319
0h 14m 53s,14319,0,785,933478,14319
0h 14m 54s,14319,479,724,933957,14319
0h 14m 55s,14319,2053,990,936010,14319
0h 14m 56s,14319,729,938,936739,14319
0h 14m 57s,14319,500,850,937239,14319
0h 14m 58s,14319,2615,1203,939854,14319
0h 14m 59s,14319,0,962,939854,14319
0h 15m 0s,14319,1384,1046,941238,14319
0h 15m 2s,14319,786,994,942024,14319
0h 15m 2s,14319,533,902,942557,14319
0h 15m 3s,14319,1376,997,943933,14319
0h 15m 4s,14319,1848,1167,945781,14319
0h 15m 5s,14319,1460,1226,947241,14319
0h 15m 6s,14319,753,1131,947994,14319
0h 15m 7s,14319,827,1070,948821,14319
0h 15m 8s,14319,2663,1389,951484,14319
0h 15m 9s,14320,714,1254,952198,14319
0h 15m 10s,14320,591,1121,952789,14320
0h 15m 11s,14320,1293,1155,954082,14320
0h 15m 12s,14320,507,1025,954589,14320
0h 15m 13s,14320,1874,1195,956463,14320
0h 15m 14s,14320,480,1052,956943,14320
0h 15m 15s,14320,751,992,957694,14320
0h 15m 16s,14320,2744,1342,960438,14320
0h 15m 17s,14320,578,1189,961016,14320
0h 15m 18s,14320,1787,1309,962803,14320
0h 15m 19s,14320,0,1047,962803,14320
0h 15m 20s,14320,1908,1219,964711,14320
0h 15m 21s,14320,0,975,964711,14320
0h 15m 22s,14320,608,902,965319,14320
0h 15m 23s,14320,1354,992,966673,14320
0h 15m 24s,14320,681,930,967354,14320
0h 15m 25s,14320,0,744,967354,14320
0h 15m 26s,14320,1083,812,968437,14320
0h 15m 27s,14320,0,650,968437,14320
0h 15m 28s,14379,1336,787,969773,14379
0h 15m 29s,14379,541,738,970314,14379
0h 15m 30s,14379,637,718,970951,14379
0h 15m 31s,14379,701,715,971652,14379
0h 15m 32s,14379,2208,1014,973860,14379
0h 15m 33s,14379,460,903,974320,14379
0h 15m 34s,14379,1059,934,975379,14379
0h 15m 35s,14379,477,843,975856,14379
0h 15m 36s,14379,524,779,976380,14379
0h 15m 37s,14379,504,724,976884,14379
0h 15m 38s,14379,1221,823,978105,14379
0h 15m 40s,14379,2263,1111,980368,14379
0h 15m 40s,14379,0,889,980368,14379
0h 15m 41s,14379,665,844,981033,14379
0h 15m 42s,14379,2810,1237,983843,14379
0h 15m 43s,14379,1182,1226,985025,14379
0h 15m 44s,14379,1721,1325,986746,14379
0h 15m 45s,14379,571,1174,987317,14379
0h 15m 46s,14379,2687,1477,990004,14379
0h 15m 47s,14379,1172,1416,991176,14379
0h 15m 48s,14379,530,1239,991706,14379
0h 15m 49s,14379,1053,1202,992759,14379
0h 15m 50s,14379,629,1087,993388,14379
0h 15m 51s,14379,775,1025,994163,14379
0h 15m 52s,14379,1059,1032,995222,14379
0h 15m 53s,14379,1220,1070,996442,14379
0h 15m 54s,14379,746,1005,997188,14379
0h 15m 55s,14379,631,930,997819,14379
0h 15m 56s,14381,1366,1017,999185,14381
0h 15m 57s,14381,1307,1075,1000492,14381
0h 15m 58s,14381,656,991,1001148,14381
0h 15m 59s,14381,2892,1371,1004040,14381
0h 16m 0s,14381,0,1097,1004040,14381
0h 16m 1s,14381,822,1042,1004862,14381
0h 16m 2s,14381,0,834,1004862,14381
0h 16m 3s,14381,1109,889,1005971,14381
0h 16m 4s,14381,1337,979,1007308,14381
0h 16m 5s,14381,1238,1031,1008546,14381
0h 16m 6s,14381,1347,1094,1009893,14381
0h 16m 7s,14381,492,974,1010385,14381
0h 16m 8s,14381,1725,1124,1012110,14381
0h 16m 9s,14381,646,1028,1012756,14381
0h 16m 10s,14381,1249,1072,1014005,14381
0h 16m 11s,14381,1117,1081,1015122,14381
0h 16m 12s,14381,0,865,1015122,14381
0h 16m 13s,14381,668,826,1015790,14381
0h 16m 14s,14381,628,786,1016418,14381
0h 16m 15s,14381,0,629,1016418,14381
0h 16m 16s,14381,659,635,1017077,14381
0h 16m 17s,14389,776,663,1017853,14389
0h 16m 18s,14389,484,627,1018337,14389
0h 16m 19s,14389,1751,852,1020088,14389
0h 16m 20s,14389,0,682,1020088,14389
0h 16m 21s,14389,1892,924,1021980,14389
0h 16m 22s,14389,795,898,1022775,14389
0h 16m 23s,14389,471,813,1023246,14389
0h 16m 24s,14389,1912,1033,1025158,14389
0h 16m 25s,14411,1358,1098,1026516,14411
0h 16m 26s,14411,2658,1410,1029174,14411
0h 16m 27s,14411,1080,1344,1030254,14411
0h 16m 28s,14411,1186,1312,1031440,14411
0h 16m 29s,14411,1695,1389,1033135,14411
0h 16m 30s,14411,1962,1504,1035097,14411
0h 16m 31s,14411,1210,1445,1036307,14411
0h 16m 32s,14411,593,1275,1036900,14411
0h 16m 33s,14411,1834,1387,1038734,14411
0h 16m 34s,14411,586,1227,1039320,14411
0h 16m 35s,14411,962,1174,1040282,14411
0h 16m 36s,14411,496,1038,1040778,14411
0h 16m 37s,14411,509,932,1041287,14411
0h 16m 38s,14411,919,929,1042206,14411
0h 16m 39s,14419,1412,1026,1043618,14419
0h 16m 40s,14419,0,821,1043618,14419
0h 16m 41s,14419,1490,955,1045108,14419
0h 16m 42s,14419,740,912,1045848,14419
0h 16m 43s,14419,1185,967,1047033,14419
0h 16m 44s,14419,1361,1046,1048394,14419
0h 16m 45s,14419,1929,1223,1050323,14419
0h 16m 46s,14419,0,978,1050323,14419
0h 16m 47s,14419,708,924,1051031,14419
0h 16m 48s,14419,1918,1123,1052949,14419
0h 16m 49s,14419,0,898,1052949,14419
0h 16m 50s,14419,577,834,1053526,14419
0h 16m 51s,14419,1200,907,1054726,14419
0h 16m 52s,14419,2825,1291,1057551,14419
0h 16m 53s,14419,547,1142,1058098,14419
0h 16m 54s,14419,1130,1140,1059228,14419
0h 16m 55s,14419,0,912,1059228,14419
0h 16m 56s,14419,596,849,1059824,14419
0h 16m 57s,14419,561,791,1060385,14419
0h 16m 58s,14419,581,749,1060966,14419
0h 16m 59s,14419,1525,904,1062491,14419
0h 17m 0s,14419,1333,990,1063824,14419
0h 17m 1s,14419,770,946,1064594,14419
0h 17m 2s,14419,2979,1353,1067573,14419
0h 17m 3s,14419,1429,1368,1069002,14419
0h 17m 4s,14419,734,1241,1069736,14419
0h 17m 5s,14419,1279,1249,1071015,14419
0h 17m 6s,14419,1355,1270,1072370,14419
0h 17m 7s,14419,0,1016,1072370,14419
0h 17m 8s,14419,1320,1077,1073690,14419
0h 17m 9s,14419,1230,1108,1074920,14419
0h 17m 10s,14419,799,1046,1075719,14419
0h 17m 11s,14419,415,920,1076134,14419
0h 17m 12s,14419,722,880,1076856,14419
0h 17m 13s,14419,0,704,1076856,14419
0h 17m 14s,14419,628,689,1077484,14419
0h 17m 15s,14419,826,716,1078310,14419
0h 17m 16s,14419,1989,971,1080299,14419
0h 17m 17s,14419,771,931,1081070,14419
0h 17m 18s,14420,754,896,1081824,14420
0h 17m 19s,14420,1045,926,1082869,14420
0h 17m 20s,14420,0,741,1082869,14420
0h 17m 21s,14420,653,723,1083522,14420
0h 17m 22s,14420,646,708,1084168,14420
0h 17m 23s,14420,421,651,1084589,14420
0h 17m 24s,14420,2666,1054,1087255,14420
0h 17m 25s,14420,626,968,1087881,14420
0h 17m 26s,14420,1159,1006,1089040,14420
0h 17m 27s,14420,633,931,1089673,14420
0h 17m 28s,14420,618,868,1090291,14420
0h 17m 29s,14420,1025,899,1091316,14420
0h 17m 30s,14420,1145,948,1092461,14420
0h 17m 31s,14420,1190,996,1093651,14420
0h 17m 32s,14420,1951,1187,1095602,14420
0h 17m 33s,14420,733,1096,1096335,14420
0h 17m 34s,14420,0,877,1096335,14420
0h 17m 35s,14430,1162,934,1097497,14430
0h 17m 36s,14430,0,747,1097497,14430
0h 17m 37s,14430,2513,1100,1100010,14430
0h 17m 38s,14430,0,880,1100010,14430
0h 17m 39s,14430,1591,1022,1101601,14430
0h 17m 40s,14430,471,912,1102072,14430
0h 17m 41s,14430,659,861,1102731,14430
0h 17m 42s,14430,2047,1098,1104778,14430
0h 17m 43s,14430,2301,1339,1107079,14430
0h 17m 44s,14430,0,1071,1107079,14430
0h 17m 45s,14430,0,857,1107079,14430
0h 17m 46s,14430,3031,1292,1110110,14430
0h 17m 47s,14430,782,1190,1110892,14430
0h 17m 48s,14430,0,952,1110892,14430
0h 17m 49s,14433,1280,1018,1112172,14430
0h 17m 51s,14435,2256,1266,1114428,14435
0h 17m 52s,14435,1279,1269,1115707,14435
0h 17m 53s,14435,0,1015,1115707,14435
0h 17m 54s,14435,546,921,1116253,14435
0h 17m 55s,14435,1942,1125,1118195,14435
0h 17m 56s,14435,1358,1172,1119553,14435
0h 17m 57s,14435,2256,1389,1121809,14435
0h 17m 58s,14435,1107,1333,1122916,14435
0h 17m 59s,14435,635,1193,1123551,14435
0h 18m 0s,14435,0,954,1123551,14435
0h 18m 1s,14435,1127,989,1124678,14435
0h 18m 2s,14435,0,791,1124678,14435
0h 18m 3s,14435,894,812,1125572,14435
0h 18m 4s,14435,1341,918,1126913,14435
0h 18m 5s,14435,0,734,1126913,14435
0h 18m 6s,14435,1224,832,1128137,14435
0h 18m 7s,14435,765,819,1128902,14435
0h 18m 8s,14435,2023,1060,1130925,14435
0h 18m 9s,14435,1315,1111,1132240,14435
0h 18m 10s,14435,1089,1107,1133329,14435
0h 18m 11s,14435,1199,1125,1134528,14435
0h 18m 12s,14435,1481,1196,1136009,14435
0h 18m 13s,14435,1591,1275,1137600,14435
0h 18m 14s,14435,1545,1329,1139145,14435
0h 18m 15s,14435,0,1063,1139145,14435
0h 18m 16s,14435,2065,1263,1141210,14435
0h 18m 17s,14435,2133,1437,1143343,14435
0h 18m 18s,14435,0,1150,1143343,14435
0h 18m 19s,14435,1781,1276,1145124,14435
0h 18m 20s,14435,415,1104,1145539,14435
0h 18m 21s,14435,2316,1346,1147855,14435
0h 18m 22s,14435,592,1195,1148447,14435
0h 18m 23s,14435,1119,1180,1149566,14435
0h 18m 24s,14435,1573,1259,1151139,14435
0h 18m 25s,14435,1530,1313,1152669,14435
0h 18m 26s,14435,2077,1466,1154746,14435
0h 18m 27s,14435,0,1173,1154746,14435
0h 18m 28s,14435,624,1063,1155370,14435
0h 18m 29s,14435,1302,1111,1156672,14435
0h 18m 30s,14435,644,1018,1157316,14435
0h 18m 31s,14435,504,915,1157820,14435
0h 18m 32s,14435,791,890,1158611,14435
0h 18m 33s,14435,724,857,1159335,14435
0h 18m 34s,14435,619,809,1159954,14435
0h 18m 35s,14435,1508,949,1161462,14435
0h 18m 36s,14435,0,759,1161462,14435
0h 18m 37s,14435,3583,1324,1165045,14435
0h 18m 38s,14435,611,1181,1165656,14435
0h 18m 39s,14437,2584,1462,1168240,14437
0h 18m 40s,14437,0,1170,1168240,14437
0h 18m 41s,14437,0,936,1168240,14437
0h 18m 42s,14437,1785,1106,1170025,14437
0h 18m 43s,14438,1448,1174,1171473,14438
0h 18m 44s,14438,636,1066,1172109,14438
0h 18m 45s,14438,595,972,1172704,14438
0h 18m 47s,14438,1849,1147,1174553,14438
0h 18m 47s,14438,613,1040,1175166,14438
0h 18m 48s,14438,0,832,1175166,14438
0h 18m 50s,14438,2180,1102,1177346,14438
0h 18m 50s,14438,0,882,1177346,14438
0h 18m 51s,14438,1300,966,1178646,14438
0h 18m 52s,14438,0,773,1178646,14438
0h 18m 53s,14438,1294,877,1179940,14438
0h 18m 54s,14438,2294,1160,1182234,14438
0h 18m 55s,14438,0,928,1182234,14438
0h 18m 56s,14438,692,881,1182926,14438
0h 18m 57s,14438,0,705,1182926,14438
0h 18m 58s,14438,596,683,1183522,14438
0h 18m 59s,14438,1248,796,1184770,14438
0h 19m 0s,14438,2522,1141,1187292,14438
0h 19m 1s,14438,485,1010,1187777,14438
0h 19m 3s,14438,2854,1379,1190631,14438
0h 19m 4s,14536,698,1243,1191329,14438
0h 19m 4s,14536,0,994,1191329,14438
0h 19m 6s,14536,2141,1223,1193470,14536
0h 19m 7s,14536,1458,1270,1194928,14536
0h 19m 7s,14536,697,1155,1195625,14536
0h 19m 9s,14536,1237,1171,1196862,14536
0h 19m 10s,14536,1292,1195,1198154,14536
0h 19m 11s,14536,1697,1295,1199851,14536
0h 19m 11s,14536,574,1151,1200425,14536
0h 19m 12s,14536,545,1030,1200970,14536
0h 19m 13s,14536,1306,1085,1202276,14536
0h 19m 14s,14536,0,868,1202276,14536
0h 19m 15s,14536,522,799,1202798,14536
0h 19m 16s,14536,706,780,1203504,14536
0h 19m 17s,14536,2114,1047,1205618,14536
0h 19m 18s,14536,0,838,1205618,14536
0h 19m 19s,14536,1604,991,1207222,14536
0h 19m 20s,14536,663,925,1207885,14536
0h 19m 21s,14536,1328,1006,1209213,14536
0h 19m 22s,14536,668,938,1209881,14536
0h 19m 23s,14536,542,859,1210423,14536
0h 19m 24s,14536,1794,1046,1212217,14536
0h 19m 25s,14536,0,837,1212217,14536
0h 19m 26s,14536,1637,997,1213854,14536
0h 19m 28s,14536,1651,1128,1215505,14536
0h 19m 28s,14536,0,902,1215505,14536
0h 19m 29s,14536,1388,999,1216893,14536
0h 19m 30s,14536,1484,1096,1218377,14536
0h 19m 32s,14536,1344,1146,1219721,14536
0h 19m 32s,14536,2740,1465,1222461,14536
0h 19m 33s,14536,1560,1484,1224021,14536
0h 19m 34s,14536,1181,1423,1225202,14536
0h 19m 35s,14536,608,1260,1225810,14536
0h 19m 36s,14536,0,1008,1225810,14536
0h 19m 37s,14536,378,882,1226188,14536
0h 19m 38s,14536,2029,1111,1228217,14536
0h 19m 39s,14536,0,889,1228217,14536
0h 19m 40s,14536,1454,1002,1229671,14536
0h 19m 41s,14536,732,948,1230403,14536
0h 19m 42s,14536,0,758,1230403,14536
0h 19m 43s,14536,0,606,1230403,14536
0h 19m 44s,14536,2123,909,1232526,14536
0h 19m 45s,14536,690,865,1233216,14536
0h 19m 46s,14536,676,827,1233892,14536
0h 19m 47s,14536,1360,934,1235252,14536
0h 19m 48s,14536,1467,1041,1236719,14536
0h 19m 49s,14539,1297,1092,1238016,14539
0h 19m 50s,14539,552,984,1238568,14539
0h 19m 52s,14540,551,897,1239119,14540
0h 19m 53s,14540,966,911,1240085,14540
0h 19m 54s,14540,0,729,1240085,14540
0h 19m 55s,14540,2697,1123,1242782,14540
0h 19m 56s,14540,1482,1195,1244264,14540
0h 19m 57s,14540,1224,1201,1245488,14540
0h 19m 58s,14540,2152,1391,1247640,14540
0h 19m 59s,14540,1533,1419,1249173,14540
0h 20m 0s,14540,1468,1429,1250641,14540
0h 20m 1s,14540,1292,1402,1251933,14540
0h 20m 2s,14540,751,1272,1252684,14540
0h 20m 3s,14540,1315,1281,1253999,14540
0h 20m 4s,14540,630,1151,1254629,14540
0h 20m 5s,14540,0,921,1254629,14540
0h 20m 6s,14541,1657,1068,1256286,14541
0h 20m 7s,14541,1900,1234,1258186,14541
0h 20m 8s,14541,0,987,1258186,14541
0h 20m 9s,14541,0,790,1258186,14541
0h 20m 10s,14541,649,762,1258835,14541
0h 20m 11s,14541,672,744,1259507,14541
0h 20m 12s,14541,808,757,1260315,14541
0h 20m 13s,14541,1141,834,1261456,14541
0h 20m 14s,14541,0,667,1261456,14541
0h 20m 15s,14541,2165,967,1263621,14541
0h 20m 16s,14541,1030,980,1264651,14541
0h 20m 17s,14541,0,784,1264651,14541
0h 20m 18s,14541,1353,898,1266004,14541
0h 20m 19s,14541,3026,1324,1269030,14541
0h 20m 20s,14541,1199,1299,1270229,14541
0h 20m 21s,14541,861,1211,1271090,14541
0h 20m 22s,14541,0,969,1271090,14541
0h 20m 23s,14541,850,945,1271940,14541
0h 20m 24s,14541,2682,1292,1274622,14541
0h 20m 25s,14541,1435,1321,1276057,14541
0h 20m 26s,14541,0,1057,1276057,14541
0h 20m 27s,14541,1328,1111,1277385,14541
0h 20m 28s,14541,0,889,1277385,14541
0h 20m 29s,14541,580,827,1277965,14541
0h 20m 30s,14541,1311,924,1279276,14541
0h 20m 31s,14541,1121,963,1280397,14541
0h 20m 32s,14541,0,770,1280397,14541
0h 20m 33s,14541,1115,839,1281512,14541
0h 20m 34s,14541,571,785,1282083,14541
0h 20m 35s,14541,1907,1009,1283990,14541
0h 20m 36s,14541,1539,1115,1285529,14541
0h 20m 37s,14541,2474,1387,1288003,14541
0h 20m 38s,14541,0,1110,1288003,14541
0h 20m 39s,14541,577,1003,1288580,14541
0h 20m 40s,14541,3231,1449,1291811,14541
0h 20m 41s,14541,692,1298,1292503,14541
0h 20m 42s,14541,702,1179,1293205,14541
0h 20m 43s,14541,1136,1170,1294341,14541
0h 20m 44s,14541,2643,1465,1296984,14541
0h 20m 45s,14541,0,1172,1296984,14541
0h 20m 46s,14541,1837,1305,1298821,14541
0h 20m 47s,14541,1399,1324,1300220,14541
0h 20m 48s,14541,1148,1289,1301368,14541
0h 20m 49s,14541,0,1031,1301368,14541
0h 20m 50s,14541,2086,1242,1303454,14541
0h 20m 51s,14541,1374,1268,1304828,14541
0h 20m 52s,14541,735,1161,1305563,14541
0h 20m 53s,14541,567,1042,1306130,14541
0h 20m 54s,14541,1590,1152,1307720,14541
0h 20m 55s,14541,747,1071,1308467,14541
0h 20m 56s,14541,0,857,1308467,14541
0h 20m 57s,14541,776,841,1309243,14541
0h 20m 58s,14541,1822,1037,1311065,14541
0h 20m 59s,14541,2538,1337,1313603,14541
0h 21m 0s,14541,0,1070,1313603,14541
0h 21m 1s,14541,0,856,1313603,14541
0h 21m 2s,14541,0,685,1313603,14541
0h 21m 3s,14541,681,684,1314284,14541
0h 21m 4s,14541,783,704,1315067,14541
0h 21m 5s,14541,1361,835,1316428,14541
0h 21m 6s,14541,0,668,1316428,14541
0h 21m 7s,14541,1731,881,1318159,14541
0h 21m 8s,14541,484,802,1318643,14541
0h 21m 9s,14541,1049,851,1319692,14541
0h 21m 10s,14541,0,681,1319692,14541
0h 21m 11s,14541,1884,922,1321576,14541
0h 21m 12s,14541,0,738,1321576,14541
0h 21m 13s,14541,2073,1005,1323649,14541
0h 21m 14s,14541,795,963,1324444,14541
0h 21m 15s,14541,685,907,1325129,14541
0h 21m 16s,14541,2076,1141,1327205,14541
0h 21m 17s,14541,1230,1159,1328435,14541
0h 21m 18s,14541,827,1093,1329262,14541
0h 21m 19s,14541,0,874,1329262,14541
0h 21m 20s,14541,1684,1036,1330946,14541
0h 21m 21s,14541,1474,1124,1332420,14541
0h 21m 22s,14541,769,1053,1333189,14541
0h 21m 23s,14541,1065,1055,1334254,14541
0h 21m 24s,14541,0,844,1334254,14541
0h 21m 25s,14541,1848,1045,1336102,14541
0h 21m 26s,14541,1267,1089,1337369,14541
0h 21m 27s,14541,1528,1177,1338897,14541
0h 21m 28s,14541,2071,1356,1340968,14541
0h 21m 29s,14541,1879,1461,1342847,14541
0h 21m 30s,14541,1287,1426,1344134,14541
0h 21m 31s,14541,691,1279,1344825,14541
0h 21m 33s,14568,1281,1279,1346106,14568
0h 21m 34s,14568,698,1163,1346804,14568
0h 21m 35s,14568,795,1089,1347599,14568
0h 21m 36s,14568,1178,1107,1348777,14568
0h 21m 36s,14568,708,1027,1349485,14568
0h 21m 37s,14568,0,822,1349485,14568
0h 21m 39s,14568,2017,1061,1351502,14568
0h 21m 39s,14568,1943,1237,1353445,14568
0h 21m 40s,14568,0,990,1353445,14568
0h 21m 41s,14568,873,967,1354318,14568
0h 21m 42s,14568,695,913,1355013,14568
0h 21m 43s,14568,2412,1213,1357425,14568
0h 21m 44s,14568,0,970,1357425,14568
0h 21m 45s,14568,3081,1392,1360506,14568
0h 21m 46s,14568,0,1114,1360506,14568
0h 21m 47s,14568,2853,1462,1363359,14568
0h 21m 48s,14568,1359,1441,1364718,14568
0h 21m 50s,14568,597,1272,1365315,14568
0h 21m 51s,14568,751,1168,1366066,14568
0h 21m 52s,14568,681,1071,1366747,14568
0h 21m 53s,14568,589,975,1367336,14568
0h 21m 54s,14568,1576,1095,1368912,14568
0h 21m 55s,14568,466,969,1369378,14568
0h 21m 56s,14568,637,903,1370015,14568
0h 21m 57s,14568,0,722,1370015,14568
0h 21m 58s,14568,1449,867,1371464,14568
0h 21m 59s,14568,1670,1028,1373134,14568
0h 22m 0s,14568,624,947,1373758,14568
0h 22m 1s,14568,613,880,1374371,14568
0h 22m 2s,14568,1329,970,1375700,14568
0h 22m 3s,14568,0,776,1375700,14568
0h 22m 4s,14568,635,748,1376335,14568
0h 22m 5s,14568,2023,1003,1378358,14568
0h 22m 6s,14568,0,802,1378358,14568
0h 22m 7s,14568,978,837,1379336,14568
0h 22m 8s,14568,0,670,1379336,14568
0h 22m 9s,14568,1297,795,1380633,14568
0h 22m 10s,14568,814,799,1381447,14568
0h 22m 11s,14568,1434,926,1382881,14568
0h 22m 12s,14568,1122,965,1384003,14568
0h 22m 13s,14568,1219,1016,1385222,14568
0h 22m 15s,14568,649,943,1385871,14568
0h 22m 15s,14568,1116,978,1386987,14568
0h 22m 16s,14568,2774,1337,1389761,14568
0h 22m 17s,14568,821,1234,1390582,14568
0h 22m 18s,14568,610,1109,1391192,14568
0h 22m 19s,14568,1289,1145,1392481,14568
0h 22m 20s,14568,0,916,1392481,14568
0h 22m 21s,14568,1404,1014,1393885,14568
0h 22m 22s,14568,1082,1028,1394967,14568
0h 22m 23s,14568,1962,1215,1396929,14568
0h 22m 24s,14568,0,972,1396929,14568
0h 22m 25s,14568,668,911,1397597,14568
0h 22m 26s,14568,609,851,1398206,14568
0h 22m 27s,14568,2064,1094,1400270,14568
0h 22m 28s,14568,347,945,1400617,14568
0h 22m 29s,14568,1474,1051,1402091,14568
0h 22m 30s,14568,553,951,1402644,14568
0h 22m 31s,14568,1829,1127,1404473,14568
0h 22m 32s,14568,1172,1136,1405645,14568
0h 22m 33s,14579,0,909,1405645,14568
0h 22m 34s,14579,550,837,1406195,14579
0h 22m 35s,14579,1435,957,1407630,14579
0h 22m 36s,14579,1181,1002,1408811,14579
0h 22m 37s,14579,832,968,1409643,14579
0h 22m 38s,14579,0,774,1409643,14579
0h 22m 39s,14579,1797,979,1411440,14579
0h 22m 40s,14579,0,783,1411440,14579
0h 22m 41s,14579,948,816,1412388,14579
0h 22m 42s,14579,655,784,1413043,14579
0h 22m 43s,14579,679,763,1413722,14579
0h 22m 44s,14579,1300,870,1415022,14579
0h 22m 45s,14579,1404,977,1416426,14579
0h 22m 46s,14579,1175,1017,1417601,14579
0h 22m 47s,14579,1321,1078,1418922,14579
0h 22m 48s,14579,0,862,1418922,14579
0h 22m 49s,14579,708,831,1419630,14579
0h 22m 50s,14579,0,665,1419630,14579
0h 22m 51s,14579,708,674,1420338,14579
0h 22m 52s,14579,1101,759,1421439,14579
0h 22m 53s,14579,2107,1029,1423546,14579
0h 22m 54s,14579,1278,1079,1424824,14579
0h 22m 55s,14579,0,863,1424824,14579
0h 22m 56s,14579,1342,959,1426166,14579
0h 22m 57s,14579,2109,1189,1428275,14579
0h 22m 58s,14579,2272,1406,1430547,14579
0h 23m 0s,14579,2005,1526,1432552,14579
0h 23m 0s,14579,0,1221,1432552,14579
0h 23m 1s,14579,1150,1207,1433702,14579
0h 23m 2s,14579,1929,1351,1435631,14579
0h 23m 3s,14579,628,1206,1436259,14579
0h 23m 4s,14579,0,965,1436259,14579
0h 23m 5s,14579,1884,1149,1438143,14579
0h 23m 6s,14579,725,1064,1438868,14579
0h 23m 7s,14579,2223,1296,1441091,14579
0h 23m 8s,14579,774,1192,1441865,14579
0h 23m 9s,14579,0,954,1441865,14579
0h 23m 10s,14579,1326,1028,1443191,14579
0h 23m 11s,14579,647,952,1443838,14579
0h 23m 12s,14579,2574,1276,1446412,14579
0h 23m 13s,14579,1303,1281,1447715,14579
0h 23m 14s,14579,1013,1227,1448728,14579
0h 23m 15s,14579,611,1104,1449339,14579
0h 23m 16s,14579,1510,1185,1450849,14579
0h 23m 17s,14579,924,1133,1451773,14579
0h 23m 18s,14579,1995,1305,1453768,14579
0h 23m 19s,14583,1846,1413,1455614,14583
0h 23m 20s,14583,1208,1372,1456822,14583
0h 23m 21s,14583,376,1173,1457198,14583
0h 23m 22s,14583,1903,1319,1459101,14583
0h 23m 23s,14583,541,1163,1459642,14583
0h 23m 24s,14583,1823,1295,1461465,14583
0h 23m 25s,14583,619,1160,1462084,14583
0h 23m 26s,14583,0,928,1462084,14583
0h 23m 27s,14583,1083,959,1463167,14583
0h 23m 28s,14583,1581,1083,1464748,14583
0h 23m 29s,14583,2074,1281,1466822,14583
0h 23m 30s,14583,1182,1261,1468004,14583
0h 23m 31s,14583,549,1119,1468553,14583
0h 23m 32s,14583,1109,1117,1469662,14583
0h 23m 33s,14583,558,1005,1470220,14583
0h 23m 34s,14583,0,804,1470220,14583
0h 23m 35s,14583,1306,904,1471526,14583
0h 23m 36s,14583,2017,1127,1473543,14583
0h 23m 37s,14583,1207,1143,1474750,14583
0h 23m 38s,14583,386,992,1475136,14583
0h 23m 39s,14583,777,949,1475913,14583
0h 23m 40s,14583,2843,1328,1478756,14583
0h 23m 41s,14583,850,1232,1479606,14583
0h 23m 42s,14583,443,1074,1480049,14583
0h 23m 44s,14583,637,987,1480686,14583
0h 23m 45s,14583,1296,1049,1481982,14583
0h 23m 46s,14583,736,986,1482718,14583
0h 23m 47s,14583,2025,1194,1484743,14583
0h 23m 48s,14583,588,1073,1485331,14583
0h 23m 49s,14583,569,972,1485900,14583
0h 23m 50s,14583,611,900,1486511,14583
0h 23m 51s,14583,1974,1115,1488485,14583
0h 23m 52s,14583,521,996,1489006,14583
0h 23m 53s,14585,608,918,1489614,14583
0h 23m 54s,14585,1775,1089,1491389,14585
0h 23m 55s,14585,731,1017,1492120,14585
0h 23m 56s,14585,1845,1183,1493965,14585
0h 23m 57s,14585,1660,1278,1495625,14585
0h 23m 58s,14585,1157,1254,1496782,14585
0h 23m 59s,14585,1911,1385,1498693,14585
0h 24m 0s,14585,505,1209,1499198,14585
0h 24m 1s,14613,2551,1477,1501749,14613
0h 24m 3s,14613,647,1311,1502396,14613
0h 24m 3s,14613,1455,1340,1503851,14613
0h 24m 4s,14613,1559,1384,1505410,14613
0h 24m 5s,14613,752,1258,1506162,14613
0h 24m 6s,14613,0,1006,1506162,14613
0h 24m 7s,14613,0,805,1506162,14613
0h 24m 8s,14613,525,749,1506687,14613
0h 24m 9s,14613,1194,838,1507881,14613
0h 24m 10s,14613,769,824,1508650,14613
0h 24m 11s,14613,521,763,1509171,14613
0h 24m 12s,14613,1092,829,1510263,14613
0h 24m 13s,14613,493,762,1510756,14613
0h 24m 14s,14613,0,610,1510756,14613
0h 24m 15s,14613,2298,948,1513054,14613
0h 24m 16s,14613,2100,1178,1515154,14613
0h 24m 17s,14613,1732,1289,1516886,14613
0h 24m 18s,14613,1186,1268,1518072,14613
0h 24m 19s,14613,596,1134,1518668,14613
0h 24m 20s,14613,1565,1220,1520233,14613
0h 24m 21s,14613,1470,1270,1521703,14613
0h 24m 22s,14613,507,1117,1522210,14613
0h 24m 23s,14613,927,1079,1523137,14613
0h 24m 24s,14613,1316,1126,1524453,14613
0h 24m 25s,14613,0,901,1524453,14613
0h 24m 26s,14613,635,848,1525088,14613
0h 24m 27s,14613,582,795,1525670,14613
0h 24m 28s,14613,1125,861,1526795,14613
0h 24m 29s,14613,1320,953,1528115,14613
0h 24m 30s,14613,805,923,1528920,14613
0h 24m 31s,14613,747,888,1529667,14613
0h 24m 32s,14613,0,710,1529667,14613
0h 24m 33s,14613,695,707,1530362,14613
0h 24m 34s,14613,1795,925,1532157,14613
0h 24m 35s,14613,1605,1061,1533762,14613
0h 24m 36s,14613,1782,1205,1535544,14613
0h 24m 37s,14613,0,964,1535544,14613
0h 24m 38s,14613,1163,1004,1536707,14613
0h 24m 39s,14613,2726,1348,1539433,14613
0h 24m 40s,14613,1023,1283,1540456,14613
0h 24m 41s,14621,1510,1328,1541966,14621
0h 24m 42s,14621,2183,1499,1544149,14621
0h 24m 43s,14621,1683,1536,1545832,14621
0h 24m 44s,14621,603,1349,1546435,14621
0h 24m 45s,14621,0,1079,1546435,14621
0h 24m 46s,14621,0,863,1546435,14621
0h 24m 47s,14621,1350,960,1547785,14621
0h 24m 48s,14621,890,946,1548675,14621
0h 24m 49s,14621,1232,1003,1549907,14621
0h 24m 50s,14621,1615,1125,1551522,14621
0h 24m 51s,14621,1148,1130,1552670,14621
0h 24m 52s,14628,1297,1163,1553967,14628
0h 24m 53s,14628,0,930,1553967,14628
0h 24m 54s,14628,1977,1139,1555944,14628
0h 24m 55s,14628,0,911,1555944,14628
0h 24m 56s,14628,1200,969,1557144,14628
0h 24m 57s,14628,1301,1035,1558445,14628
0h 24m 58s,14628,638,956,1559083,14628
0h 24m 59s,14628,1269,1019,1560352,14628
0h 25m 0s,14628,2158,1247,1562510,14628
0h 25m 1s,14628,710,1140,1563220,14628
0h 25m 2s,14628,647,1041,1563867,14628
0h 25m 3s,14628,0,833,1563867,14628
0h 25m 4s,14628,1387,944,1565254,14628
0h 25m 5s,14628,1409,1037,1566663,14628
0h 25m 6s,14628,663,962,1567326,14628
0h 25m 7s,14628,1300,1030,1568626,14628
0h 25m 8s,14628,0,824,1568626,14628
0h 25m 9s,14628,549,769,1569175,14628
0h 25m 10s,14628,2449,1105,1571624,14628
0h 25m 11s,14628,1312,1146,1572936,14628
0h 25m 12s,14628,1464,1210,1574400,14628
0h 25m 13s,14628,722,1112,1575122,14628
0h 25m 14s,14628,1217,1133,1576339,14628
0h 25m 15s,14628,683,1043,1577022,14628
0h 25m 16s,14628,1231,1081,1578253,14628
0h 25m 17s,14628,1430,1151,1579683,14628
0h 25m 18s,14628,644,1050,1580327,14628
0h 25m 19s,14628,1335,1107,1581662,14628
0h 25m 20s,14628,853,1056,1582515,14628
0h 25m 21s,14628,719,989,1583234,14628
0h 25m 22s,14628,2634,1318,1585868,14628
0h 25m 23s,14628,1175,1289,1587043,14628
0h 25m 24s,14628,0,1031,1587043,14628
0h 25m 25s,14628,515,928,1587558,14628
0h 25m 26s,14628,1450,1032,1589008,14628
0h 25m 27s,14628,600,946,1589608,14628
0h 25m 28s,14628,479,853,1590087,14628
0h 25m 29s,14628,2298,1142,1592385,14628
0h 25m 30s,14628,568,1027,1592953,14628
0h 25m 31s,14628,0,822,1592953,14628
0h 25m 32s,14628,721,802,1593674,14628
0h 25m 33s,14628,2155,1073,1595829,14628
0h 25m 34s,14628,737,1006,1596566,14628
0h 25m 35s,14628,648,934,1597214,14628
0h 25m 36s,14628,485,844,1597699,14628
0h 25m 37s,14628,0,675,1597699,14628
0h 25m 38s,14628,3199,1180,1600898,14628
0h 25m 39s,14628,0,944,1600898,14628
0h 25m 40s,14628,0,755,1600898,14628
0h 25m 41s,14628,1670,938,1602568,14628
0h 25m 42s,14628,1256,1002,1603824,14628
0h 25m 43s,14628,1294,1060,1605118,14628
0h 25m 45s,14628,505,949,1605623,14628
0h 25m 46s,14628,781,915,1606404,14628
0h 25m 47s,14628,1439,1020,1607843,14628
0h 25m 48s,14628,2631,1342,1610474,14628
0h 25m 49s,14628,0,1074,1610474,14628
0h 25m 50s,14628,1266,1112,1611740,14628
0h 25m 51s,14628,942,1078,1612682,14628
0h 25m 52s,14628,0,862,1612682,14628
0h 25m 53s,14628,3412,1372,1616094,14628
0h 25m 54s,14628,591,1216,1616685,14628
0h 25m 55s,14628,586,1090,1617271,14628
0h 25m 56s,14628,1973,1267,1619244,14628
0h 25m 57s,14628,653,1144,1619897,14628
0h 25m 58s,14628,1149,1145,1621046,14628
0h 25m 59s,14628,1572,1230,1622618,14628
0h 26m 0s,14628,1014,1187,1623632,14628
0h 26m 1s,14628,1426,1235,1625058,14628
0h 26m 2s,14628,1319,1252,1626377,14628
0h 26m 3s,14628,998,1201,1627375,14628
0h 26m 4s,14628,0,961,1627375,14628
0h 26m 5s,14629,1881,1145,1629256,14629
0h 26m 6s,14629,0,916,1629256,14629
0h 26m 8s,14629,2123,1157,1631379,14629
0h 26m 8s,14629,0,926,1631379,14629
0h 26m 9s,14629,577,856,1631956,14629
0h 26m 10s,14629,520,789,1632476,14629
0h 26m 12s,14629,621,755,1633097,14629
0h 26m 12s,14629,921,788,1634018,14629
0h 26m 13s,14629,2228,1076,1636246,14629
0h 26m 15s,14629,669,995,1636915,14629
0h 26m 15s,14629,1023,1001,1637938,14629
0h 26m 16s,14629,1242,1049,1639180,14629
0h 26m 17s,14629,0,839,1639180,14629
0h 26m 18s,14629,1128,897,1640308,14629
0h 26m 19s,14629,2170,1152,1642478,14629
0h 26m 20s,14629,1812,1284,1644290,14629
0h 26m 21s,14629,404,1108,1644694,14629
0h 26m 22s,14629,2260,1338,1646954,14629
0h 26m 23s,14629,615,1193,1647569,14629
0h 26m 25s,14629,1887,1332,1649456,14629
0h 26m 25s,14629,0,1066,1649456,14629
0h 26m 26s,14629,2592,1371,1652048,14629
0h 26m 27s,14629,1428,1382,1653476,14629
0h 26m 28s,14629,0,1106,1653476,14629
0h 26m 29s,14629,1114,1108,1654590,14629
0h 26m 30s,14629,1349,1156,1655939,14629
0h 26m 31s,14629,746,1074,1656685,14629
0h 26m 32s,14629,2183,1296,1658868,14629
0h 26m 33s,14629,640,1165,1659508,14629
0h 26m 34s,14629,1159,1164,1660667,14629
0h 26m 35s,14629,401,1011,1661068,14629
0h 26m 36s,14629,622,933,1661690,14629
0h 26m 37s,14629,0,746,1661690,14629
0h 26m 38s,14629,1333,863,1663023,14629
0h 26m 39s,14629,1282,947,1664305,14629
0h 26m 40s,14629,2397,1237,1666702,14629
0h 26m 41s,14629,1161,1222,1667863,14629
0h 26m 42s,14629,0,978,1667863,14629
0h 26m 43s,14629,529,888,1668392,14629
0h 26m 44s,14629,747,860,1669139,14629
0h 26m 45s,14629,2062,1100,1671201,14629
0h 26m 46s,14629,0,880,1671201,14629
0h 26m 47s,14629,0,704,1671201,14629
0h 26m 48s,14629,1610,885,1672811,14629
0h 26m 49s,14629,0,708,1672811,14629
0h 26m 50s,14629,1898,946,1674709,14629
0h 26m 51s,14629,1975,1152,1676684,14629
0h 26m 52s,14629,1025,1127,1677709,14629
0h 26m 53s,14629,744,1050,1678453,14629
0h 26m 54s,14629,0,840,1678453,14629
0h 26m 55s,14631,705,813,1679158,14629
0h 26m 56s,14631,1713,993,1680871,14631
0h 26m 57s,14631,0,794,1680871,14631
0h 26m 58s,14631,2414,1118,1683285,14631
0h 26m 59s,14631,1296,1154,1684581,14631
0h 27m 0s,14631,1593,1242,1686174,14631
0h 27m 1s,14636,2927,1579,1689101,14636
0h 27m 2s,14636,967,1457,1690068,14636
0h 27m 3s,14636,1845,1535,1691913,14636
0h 27m 4s,14636,0,1228,1691913,14636
0h 27m 5s,14636,2281,1439,1694194,14636
0h 27m 6s,14636,534,1258,1694728,14636
0h 27m 7s,14636,602,1127,1695330,14636
0h 27m 8s,14636,0,902,1695330,14636
0h 27m 9s,14636,1325,987,1696655,14636
0h 27m 10s,14636,521,894,1697176,14636
0h 27m 11s,14636,2203,1156,1699379,14636
0h 27m 12s,14636,0,925,1699379,14636
0h 27m 13s,14636,610,862,1699989,14636
0h 27m 14s,14636,1350,960,1701339,14636
0h 27m 15s,14636,697,907,1702036,14636
0h 27m 16s,14636,622,850,1702658,14636
0h 27m 17s,14636,2457,1171,1705115,14636
0h 27m 19s,14647,1231,1183,1706346,14647
0h 27m 19s,14647,1286,1204,1707632,14647
0h 27m 20s,14647,541,1071,1708173,14647
0h 27m 22s,14647,1147,1086,1709320,14647
0h 27m 23s,14647,1483,1165,1710803,14647
0h 27m 24s,14647,1882,1308,1712685,14647
0h 27m 24s,14647,747,1196,1713432,14647
0h 27m 25s,14647,1102,1177,1714534,14647
0h 27m 26s,14647,1384,1218,1715918,14647
0h 27m 28s,14647,1339,1242,1717257,14647
0h 27m 28s,14647,2755,1545,1720012,14647
0h 27m 29s,14647,593,1355,1720605,14647
0h 27m 30s,14647,0,1084,1720605,14647
0h 27m 31s,14647,554,978,1721159,14647
0h 27m 32s,14647,1309,1044,1722468,14647
0h 27m 33s,14647,488,933,1722956,14647
0h 27m 34s,14647,1452,1037,1724408,14647
0h 27m 35s,14647,2083,1246,1726491,14647
0h 27m 36s,14647,0,997,1726491,14647
0h 27m 37s,14647,2529,1303,1729020,14647
0h 27m 38s,14647,1589,1360,1730609,14647
0h 27m 39s,14647,375,1163,1730984,14647
0h 27m 40s,14647,0,930,1730984,14647
0h 27m 41s,14647,0,744,1730984,14647
0h 27m 42s,14647,1691,933,1732675,14647
0h 27m 43s,14647,645,875,1733320,14647
0h 27m 44s,14647,0,700,1733320,14647
0h 27m 45s,14647,494,659,1733814,14647
0h 27m 46s,14647,1456,818,1735270,14647
0h 27m 47s,14647,624,779,1735894,14647
0h 27m 48s,14647,667,757,1736561,14647
0h 27m 49s,14647,1440,894,1738001,14647
0h 27m 50s,14647,691,853,1738692,14647
0h 27m 52s,14647,1283,939,1739975,14647
0h 27m 53s,14647,824,916,1740799,14647
0h 27m 54s,14647,610,855,1741409,14647
0h 27m 55s,14647,722,828,1742131,14647
0h 27m 56s,14647,2911,1245,1745042,14647
0h 27m 57s,14647,1993,1395,1747035,14647
0h 27m 58s,14647,524,1221,1747559,14647
0h 27m 59s,14647,1910,1359,1749469,14647
0h 28m 1s,14647,1568,1401,1751037,14647
0h 28m 1s,14647,579,1237,1751616,14647
0h 28m 2s,14647,0,990,1751616,14647
0h 28m 3s,14647,1208,1034,1752824,14647
0h 28m 4s,14647,2402,1308,1755226,14647
0h 28m 5s,14647,0,1046,1755226,14647
0h 28m 6s,14647,1048,1046,1756274,14647
0h 28m 7s,14647,2247,1286,1758521,14647
0h 28m 8s,14647,844,1198,1759365,14647
0h 28m 9s,14647,674,1093,1760039,14647
0h 28m 10s,14647,1272,1129,1761311,14647
0h 28m 11s,14647,382,980,1761693,14647
0h 28m 12s,14647,518,888,1762211,14647
0h 28m 13s,14647,704,851,1762915,14647
0h 28m 14s,14647,1422,965,1764337,14647
0h 28m 15s,14647,1158,1004,1765495,14647
0h 28m 16s,14647,1780,1159,1767275,14647
0h 28m 17s,14647,552,1038,1767827,14647
0h 28m 18s,14647,0,830,1767827,14647
0h 28m 19s,14647,677,799,1768504,14647
0h 28m 20s,14647,1359,911,1769863,14647
0h 28m 21s,14647,1053,939,1770916,14647
0h 28m 22s,14647,0,751,1770916,14647
0h 28m 23s,14647,1764,954,1772680,14647
0h 28m 24s,14647,2331,1229,1775011,14647
0h 28m 25s,14647,1102,1204,1776113,14647
0h 28m 26s,14778,759,1115,1776872,14647
0h 28m 27s,14778,1303,1153,1778175,14778
0h 28m 28s,14778,0,922,1778175,14778
0h 28m 30s,14778,2024,1142,1780199,14778
0h 28m 30s,14778,301,974,1780500,14778
0h 28m 31s,14778,1692,1118,1782192,14778
0h 28m 32s,14778,0,894,1782192,14778
0h 28m 33s,14778,1451,1005,1783643,14778
0h 28m 34s,14778,0,804,1783643,14778
0h 28m 36s,14778,1497,943,1785140,14778
0h 28m 36s,14778,0,754,1785140,14778
0h 28m 37s,14778,2254,1054,1787394,14778
0h 28m 38s,14778,1887,1221,1789281,14778
0h 28m 39s,14778,0,977,1789281,14778
0h 28m 40s,14778,486,879,1789767,14778
0h 28m 41s,14778,586,820,1790353,14778
0h 28m 42s,14778,1235,903,1791588,14778
0h 28m 43s,14779,0,722,1791588,14778
0h 28m 44s,14779,1047,787,1792635,14779
0h 28m 46s,14781,1218,873,1793853,14781
0h 28m 46s,14781,733,845,1794586,14781
0h 28m 47s,14781,1216,919,1795802,14781
0h 28m 48s,14781,0,735,1795802,14781
0h 28m 49s,14792,0,588,1795802,14781
0h 28m 51s,14792,1191,709,1796993,14792
0h 28m 52s,14792,1320,831,1798313,14792
0h 28m 52s,14792,1320,929,1799633,14792
0h 28m 53s,14792,1047,953,1800680,14792
0h 28m 54s,14792,1255,1013,1801935,14792
0h 28m 55s,14792,0,810,1801935,14792
0h 28m 57s,14792,2678,1184,1804613,14792
0h 28m 57s,14792,0,947,1804613,14792
0h 28m 58s,14792,2814,1320,1807427,14792
0h 28m 59s,14792,0,1056,1807427,14792
0h 29m 0s,14792,634,972,1808061,14792
0h 29m 1s,14792,1926,1163,1809987,14792
0h 29m 2s,14792,609,1052,1810596,14792
0h 29m 3s,14792,1779,1197,1812375,14792
0h 29m 4s,14792,0,958,1812375,14792
0h 29m 5s,14792,1638,1094,1814013,14792
0h 29m 6s,14792,0,875,1814013,14792
0h 29m 7s,14792,675,835,1814688,14792
0h 29m 8s,14792,1582,984,1816270,14792
0h 29m 9s,14792,1091,1005,1817361,14792
0h 29m 10s,14792,1458,1096,1818819,14792
0h 29m 11s,14792,770,1031,1819589,14792
0h 29m 12s,14792,577,940,1820166,14792
0h 29m 13s,14792,1969,1146,1822135,14792
0h 29m 14s,14792,0,917,1822135,14792
0h 29m 15s,14792,0,734,1822135,14792
0h 29m 16s,14792,2809,1149,1824944,14792
0h 29m 18s,14792,581,1035,1825525,14792
0h 29m 18s,14792,1819,1192,1827344,14792
0h 29m 19s,14792,0,954,1827344,14792
0h 29m 20s,14792,749,913,1828093,14792
0h 29m 21s,14792,1338,998,1829431,14792
0h 29m 22s,14792,694,937,1830125,14792
0h 29m 23s,14792,1515,1053,1831640,14792
0h 29m 24s,14792,588,960,1832228,14792
0h 29m 25s,14792,485,865,1832713,14792
0h 29m 26s,14792,1307,953,1834020,14792
0h 29m 27s,14792,0,762,1834020,14792
0h 29m 28s,14792,606,731,1834626,14792
0h 29m 29s,14792,2199,1025,1836825,14792
0h 29m 30s,14792,1308,1082,1838133,14792
0h 29m 31s,14792,0,866,1838133,14792
0h 29m 32s,14792,539,801,1838672,14792
0h 29m 33s,14792,720,785,1839392,14792
0h 29m 34s,14792,0,628,1839392,14792
0h 29m 35s,14792,1673,837,1841065,14792
0h 29m 36s,14792,645,799,1841710,14792
0h 29m 37s,14792,2210,1081,1843920,14792
0h 29m 38s,14792,1861,1237,1845781,14792
0h 29m 39s,14792,690,1128,1846471,14792
0h 29m 40s,14792,679,1038,1847150,14792
0h 29m 41s,14792,1940,1218,1849090,14792
0h 29m 42s,14792,1020,1178,1850110,14792
0h 29m 43s,14792,2160,1374,1852270,14792
0h 29m 44s,14792,704,1240,1852974,14792
0h 29m 45s,14792,739,1140,1853713,14792
0h 29m 46s,14792,0,912,1853713,14792
0h 29m 47s,14792,0,730,1853713,14792
0h 29m 48s,14792,655,715,1854368,14792
0h 29m 49s,14792,1453,863,1855821,14792
0h 29m 50s,14792,1581,1007,1857402,14792
0h 29m 51s,14807,706,947,1858108,14792
0h 29m 52s,14807,485,855,1858593,14807
0h 29m 53s,14807,1269,938,1859862,14807
0h 29m 54s,14807,503,851,1860365,14807
0h 29m 55s,14807,698,820,1861063,14807
0h 29m 56s,14807,551,766,1861614,14807
0h 29m 57s,14807,0,613,1861614,14807
0h 29m 58s,14807,771,645,1862385,14807
0h 29m 59s,14807,1482,812,1863867,14807
