Elapsed Time,Coverage,Exec/s,Avg Exec/s,Total Execs,MaxCov
0h 0m 0s,6672,0,0,0,0
0h 0m 1s,9547,0,0,0,0
0h 0m 2s,9549,0,0,0,0
0h 0m 3s,12280,0,0,0,0
0h 0m 4s,12411,0,0,0,0
0h 0m 5s,12413,0,0,0,0
0h 0m 6s,12419,381,76,381,12417
0h 0m 7s,12425,647,190,1028,12419
0h 0m 8s,12432,552,262,1580,12432
0h 0m 9s,12432,1681,546,3261,12432
0h 0m 10s,12547,1182,673,4443,12547
0h 0m 11s,12547,1244,787,5687,12547
0h 0m 12s,12552,1290,888,6977,12550
0h 0m 13s,12571,730,856,7707,12552
0h 0m 14s,12667,2002,1085,9709,12667
0h 0m 15s,12682,1358,1140,11067,12681
0h 0m 16s,12682,730,1058,11797,12682
0h 0m 17s,12790,693,985,12490,12684
0h 0m 18s,12790,1172,1022,13662,12790
0h 0m 19s,12790,1400,1098,15062,12790
0h 0m 20s,12829,700,1018,15762,12790
0h 0m 21s,12829,752,965,16514,12829
0h 0m 22s,12853,0,772,16514,12829
0h 0m 23s,12854,1368,891,17882,12854
0h 0m 24s,12854,873,887,18755,12854
0h 0m 25s,12943,594,828,19349,12943
0h 0m 26s,12944,2108,1084,21457,12944
0h 0m 27s,12945,674,1002,22131,12945
0h 0m 28s,12945,1663,1134,23794,12945
0h 0m 29s,12947,1309,1169,25103,12945
0h 0m 30s,12947,2022,1340,27125,12947
0h 0m 31s,12947,0,1072,27125,12947
0h 0m 32s,12947,530,964,27655,12947
0h 0m 33s,12986,2371,1245,30026,12986
0h 0m 34s,12986,1512,1298,31538,12986
0h 0m 35s,12987,485,1135,32023,12986
0h 0m 36s,13043,1822,1272,33845,13043
0h 0m 37s,13046,701,1158,34546,13046
0h 0m 38s,13046,1511,1229,36057,13046
0h 0m 39s,13046,1539,1291,37596,13046
0h 0m 40s,13046,0,1033,37596,13046
0h 0m 41s,13046,535,933,38131,13046
0h 0m 42s,13047,1327,1012,39458,13047
0h 0m 43s,13048,3251,1460,42709,13047
0h 0m 44s,13048,489,1266,43198,13048
0h 0m 45s,13048,1175,1248,44373,13048
0h 0m 46s,13080,565,1111,44938,13048
0h 0m 47s,13080,0,889,44938,13048
0h 0m 48s,13080,920,895,45858,13080
0h 0m 49s,13080,1429,1002,47287,13080
0h 0m 50s,13095,678,937,47965,13080
0h 0m 51s,13138,757,901,48722,13138
0h 0m 52s,13138,1964,1114,50686,13138
0h 0m 53s,13139,1245,1140,51931,13139
0h 0m 54s,13139,1469,1206,53400,13139
0h 0m 55s,13139,1157,1196,54557,13139
0h 0m 56s,13139,823,1121,55380,13139
0h 0m 57s,13141,1554,1208,56934,13141
0h 0m 58s,13142,1319,1230,58253,13142
0h 0m 59s,13142,622,1108,58875,13142
0h 1m 0s,13142,655,1017,59530,13142
0h 1m 1s,13142,1349,1083,60879,13142
0h 1m 2s,13142,1949,1256,62828,13142
0h 1m 3s,13142,1161,1237,63989,13142
0h 1m 4s,13165,1848,1359,65837,13165
0h 1m 5s,13165,1304,1348,67141,13165
0h 1m 6s,13166,1628,1404,68769,13166
0h 1m 7s,13166,0,1123,68769,13166
0h 1m 8s,13166,605,1019,69374,13166
0h 1m 9s,13166,0,815,69374,13166
0h 1m 10s,13166,2304,1113,71678,13166
0h 1m 11s,13166,1359,1162,73037,13166
0h 1m 12s,13166,529,1035,73566,13166
0h 1m 13s,13166,1850,1198,75416,13166
0h 1m 14s,13166,651,1089,76067,13166
0h 1m 15s,13181,1120,1095,77187,13172
0h 1m 16s,13181,1312,1138,78499,13181
0h 1m 17s,13189,4423,1795,82922,13189
0h 1m 18s,13189,0,1436,82922,13189
0h 1m 19s,13189,565,1262,83487,13189
0h 1m 20s,13189,678,1145,84165,13189
0h 1m 21s,13189,1886,1293,86051,13189
0h 1m 22s,13189,1891,1413,87942,13189
0h 1m 23s,13189,697,1270,88639,13189
0h 1m 24s,13190,1176,1251,89815,13189
0h 1m 25s,13191,1984,1398,91799,13190
0h 1m 26s,13191,838,1286,92637,13191
0h 1m 27s,13196,735,1176,93372,13191
0h 1m 28s,13198,543,1049,93915,13198
0h 1m 29s,13198,2106,1260,96021,13198
0h 1m 30s,13198,1526,1313,97547,13198
0h 1m 31s,13198,1899,1430,99446,13198
0h 1m 32s,13198,543,1253,99989,13198
0h 1m 33s,13198,2919,1586,102908,13198
0h 1m 34s,13198,1163,1501,104071,13198
0h 1m 35s,13199,571,1315,104642,13199
0h 1m 36s,13199,1907,1433,106549,13199
0h 1m 37s,13199,1258,1398,107807,13199
0h 1m 38s,13199,623,1243,108430,13199
0h 1m 39s,13199,1074,1209,109504,13199
0h 1m 40s,13199,1480,1263,110984,13199
0h 1m 41s,13275,1705,1351,112689,13275
0h 1m 42s,13275,995,1280,113684,13275
0h 1m 43s,13280,0,1024,113684,13275
0h 1m 44s,13280,1478,1115,115162,13280
0h 1m 45s,13280,1703,1233,116865,13280
0h 1m 46s,13280,1452,1277,118317,13280
0h 1m 47s,13280,1189,1259,119506,13280
0h 1m 48s,13290,1879,1383,121385,13280
0h 1m 49s,13290,510,1208,121895,13290
0h 1m 50s,13290,1253,1217,123148,13290
0h 1m 51s,13290,0,974,123148,13290
0h 1m 52s,13302,1356,1050,124504,13302
0h 1m 53s,13302,1550,1150,126054,13302
0h 1m 54s,13304,761,1072,126815,13302
0h 1m 55s,13306,1177,1093,127992,13306
0h 1m 56s,13306,454,965,128446,13306
0h 1m 57s,13306,497,871,128943,13306
0h 1m 58s,13306,0,697,128943,13306
0h 1m 59s,13313,0,558,128943,13306
0h 2m 0s,13313,2763,999,131706,13313
0h 2m 1s,13314,1408,1081,133114,13314
0h 2m 2s,13314,0,865,133114,13314
0h 2m 3s,13314,1430,978,134544,13314
0h 2m 4s,13314,664,915,135208,13314
0h 2m 5s,13314,3088,1350,138296,13314
0h 2m 6s,13317,2543,1589,140839,13317
0h 2m 7s,13317,0,1271,140839,13317
0h 2m 8s,13317,2375,1492,143214,13317
0h 2m 9s,13317,2063,1606,145277,13317
0h 2m 10s,13317,0,1285,145277,13317
0h 2m 11s,13317,620,1152,145897,13317
0h 2m 12s,13317,684,1058,146581,13317
0h 2m 13s,13317,2637,1374,149218,13317
0h 2m 14s,13320,0,1099,149218,13317
0h 2m 15s,13320,1224,1124,150442,13320
0h 2m 16s,13320,1564,1212,152006,13320
0h 2m 17s,13320,0,970,152006,13320
0h 2m 18s,13320,2502,1276,154508,13320
0h 2m 19s,13320,380,1097,154888,13320
0h 2m 20s,13320,585,995,155473,13320
0h 2m 21s,13321,2483,1293,157956,13320
0h 2m 22s,13323,1186,1272,159142,13321
0h 2m 23s,13324,0,1018,159142,13321
0h 2m 24s,13324,549,924,159691,13324
0h 2m 25s,13324,2536,1246,162227,13324
0h 2m 26s,13324,2683,1533,164910,13324
0h 2m 27s,13324,1054,1437,165964,13324
0h 2m 28s,13324,1752,1500,167716,13324
0h 2m 29s,13324,613,1323,168329,13324
0h 2m 30s,13324,1196,1298,169525,13324
0h 2m 31s,13325,398,1118,169923,13324
0h 2m 32s,13325,1644,1223,171567,13325
0h 2m 33s,13325,2177,1414,173744,13325
0h 2m 34s,13325,0,1131,173744,13325
0h 2m 35s,13331,2573,1419,176317,13331
0h 2m 36s,13331,1355,1406,177672,13331
0h 2m 37s,13363,1273,1379,178945,13363
0h 2m 38s,13363,1410,1385,180355,13363
0h 2m 39s,13363,1453,1399,181808,13363
0h 2m 40s,13364,1332,1386,183140,13363
0h 2m 41s,13364,2590,1627,185730,13364
0h 2m 42s,13364,1262,1554,186992,13364
0h 2m 43s,13364,495,1342,187487,13364
0h 2m 44s,13440,610,1196,188097,13440
0h 2m 45s,13457,2804,1518,190901,13457
0h 2m 46s,13457,418,1298,191319,13457
0h 2m 47s,13460,1866,1412,193185,13460
0h 2m 48s,13460,0,1130,193185,13460
0h 2m 49s,13460,577,1019,193762,13460
0h 2m 50s,13462,810,977,194572,13462
0h 2m 51s,13462,1781,1138,196353,13462
0h 2m 52s,13462,597,1030,196950,13462
0h 2m 53s,13462,1636,1151,198586,13462
0h 2m 54s,13462,0,921,198586,13462
0h 2m 55s,13462,1769,1091,200355,13462
0h 2m 56s,13462,0,873,200355,13462
0h 2m 57s,13462,3340,1366,203695,13462
0h 2m 58s,13462,594,1212,204289,13462
0h 2m 59s,13462,1362,1242,205651,13462
0h 3m 0s,13462,1363,1266,207014,13462
0h 3m 1s,13462,1662,1345,208676,13462
0h 3m 2s,13462,664,1209,209340,13462
0h 3m 3s,13462,1880,1343,211220,13462
0h 3m 4s,13462,955,1265,212175,13462
0h 3m 5s,13462,2367,1485,214542,13462
0h 3m 6s,13462,0,1188,214542,13462
0h 3m 7s,13462,561,1063,215103,13462
0h 3m 8s,13462,2973,1445,218076,13462
0h 3m 9s,13462,1238,1404,219314,13462
0h 3m 10s,13462,590,1241,219904,13462
0h 3m 11s,13462,1588,1310,221492,13462
0h 3m 12s,13464,612,1170,222104,13464
0h 3m 13s,13468,1460,1228,223564,13468
0h 3m 14s,13468,0,982,223564,13468
0h 3m 15s,13468,1525,1091,225089,13468
0h 3m 16s,13468,651,1003,225740,13468
0h 3m 17s,13468,2145,1231,227885,13468
0h 3m 18s,13468,730,1131,228615,13468
0h 3m 19s,13468,669,1039,229284,13468
0h 3m 20s,13468,2727,1377,232011,13468
0h 3m 21s,13468,1227,1347,233238,13468
0h 3m 22s,13468,2709,1619,235947,13468
0h 3m 23s,13470,1178,1531,237125,13468
0h 3m 24s,13470,2099,1645,239224,13470
0h 3m 25s,13470,1511,1618,240735,13470
0h 3m 26s,13478,1121,1519,241856,13470
0h 3m 27s,13478,0,1215,241856,13470
0h 3m 28s,13478,3125,1597,244981,13478
0h 3m 29s,13478,586,1395,245567,13478
0h 3m 30s,13478,1894,1495,247461,13478
0h 3m 31s,13478,0,1196,247461,13478
0h 3m 32s,13478,1261,1209,248722,13478
0h 3m 33s,13478,1238,1215,249960,13478
0h 3m 34s,13478,0,972,249960,13478
0h 3m 35s,13478,2018,1181,251978,13478
0h 3m 36s,13478,1469,1239,253447,13478
0h 3m 37s,13478,0,991,253447,13478
0h 3m 38s,13478,881,969,254328,13478
0h 3m 39s,13478,3556,1486,257884,13478
0h 3m 40s,13478,1296,1448,259180,13478
0h 3m 41s,13478,1371,1433,260551,13478
0h 3m 42s,13478,1063,1359,261614,13478
0h 3m 43s,13483,600,1207,262214,13483
0h 3m 44s,13483,1124,1190,263338,13483
0h 3m 45s,13487,1394,1231,264732,13486
0h 3m 46s,13487,549,1095,265281,13487
0h 3m 47s,13488,2856,1447,268137,13488
0h 3m 48s,13488,475,1253,268612,13488
0h 3m 49s,13488,3235,1649,271847,13488
0h 3m 50s,13488,1120,1543,272967,13488
0h 3m 51s,13488,0,1234,272967,13488
0h 3m 52s,13490,1806,1348,274773,13490
0h 3m 53s,13490,1390,1356,276163,13490
0h 3m 54s,13490,0,1085,276163,13490
0h 3m 55s,13490,0,868,276163,13490
0h 3m 56s,13490,2935,1281,279098,13490
0h 3m 57s,13493,626,1150,279724,13490
0h 3m 59s,13493,1359,1192,281083,13493
0h 4m 0s,13493,0,954,281083,13493
0h 4m 1s,13493,741,911,281824,13493
0h 4m 2s,13493,597,848,282421,13493
0h 4m 3s,13493,595,797,283016,13493
0h 4m 4s,13493,1738,985,284754,13493
0h 4m 5s,13493,1129,1014,285883,13493
0h 4m 6s,13513,2401,1291,288284,13513
0h 4m 7s,13513,2538,1540,290822,13513
0h 4m 8s,13513,683,1369,291505,13513
0h 4m 9s,13513,1114,1318,292619,13513
0h 4m 10s,13513,1757,1406,294376,13513
0h 4m 11s,13513,1362,1397,295738,13513
0h 4m 12s,13513,2012,1520,297750,13513
0h 4m 13s,13513,1406,1497,299156,13513
0h 4m 14s,13513,2303,1658,301459,13513
0h 4m 15s,13513,0,1326,301459,13513
0h 4m 16s,13513,692,1199,302151,13513
0h 4m 17s,13513,1907,1341,304058,13513
0h 4m 18s,13515,747,1222,304805,13515
0h 4m 19s,13517,2167,1411,306972,13517
0h 4m 20s,13517,627,1254,307599,13517
0h 4m 21s,13517,0,1003,307599,13517
0h 4m 22s,13517,1136,1030,308735,13517
0h 4m 23s,13517,1488,1122,310223,13517
0h 4m 24s,13517,1488,1195,311711,13517
0h 4m 25s,13517,1701,1296,313412,13517
0h 4m 26s,13517,625,1162,314037,13517
0h 4m 27s,13517,556,1041,314593,13517
0h 4m 28s,13517,1314,1096,315907,13517
0h 4m 29s,13517,633,1003,316540,13517
0h 4m 30s,13517,0,802,316540,13517
0h 4m 31s,13517,3111,1264,319651,13517
0h 4m 32s,13517,679,1147,320330,13517
0h 4m 33s,13517,618,1041,320948,13517
0h 4m 34s,13517,1955,1224,322903,13517
0h 4m 35s,13517,1542,1288,324445,13517
0h 4m 36s,13517,1077,1246,325522,13517
0h 4m 37s,13517,2405,1478,327927,13517
0h 4m 38s,13517,583,1299,328510,13517
0h 4m 39s,13517,2230,1485,330740,13517
0h 4m 40s,13517,0,1188,330740,13517
0h 4m 41s,13521,1303,1211,332043,13521
0h 4m 42s,13521,2294,1428,334337,13521
0h 4m 43s,13521,2414,1625,336751,13521
0h 4m 44s,13521,656,1431,337407,13521
0h 4m 45s,13521,1316,1408,338723,13521
0h 4m 46s,13521,1853,1497,340576,13521
0h 4m 47s,13521,732,1344,341308,13521
0h 4m 48s,13521,0,1075,341308,13521
0h 4m 49s,13521,1317,1123,342625,13521
0h 4m 50s,13521,0,898,342625,13521
0h 4m 51s,13521,1341,987,343966,13521
0h 4m 52s,13521,2062,1202,346028,13521
0h 4m 53s,13521,463,1054,346491,13521
0h 4m 54s,13521,564,956,347055,13521
0h 4m 55s,13521,3030,1371,350085,13521
0h 4m 56s,13521,0,1097,350085,13521
0h 4m 57s,13521,2505,1379,352590,13521
0h 4m 58s,13521,0,1103,352590,13521
0h 4m 59s,13521,1475,1177,354065,13521
0h 5m 0s,13521,0,942,354065,13521
0h 5m 1s,13522,771,908,354836,13521
0h 5m 2s,13522,1927,1112,356763,13522
0h 5m 3s,13522,0,890,356763,13522
0h 5m 4s,13522,794,871,357557,13522
0h 5m 5s,13522,610,819,358167,13522
0h 5m 6s,13522,1313,918,359480,13522
0h 5m 7s,13522,2474,1229,361954,13522
0h 5m 8s,13523,2446,1472,364400,13522
0h 5m 9s,13528,687,1315,365087,13528
0h 5m 10s,13528,2712,1594,367799,13528
0h 5m 11s,13528,1339,1543,369138,13528
0h 5m 12s,13528,704,1375,369842,13528
0h 5m 13s,13528,681,1236,370523,13528
0h 5m 14s,13531,1193,1227,371716,13531
0h 5m 15s,13534,2066,1395,373782,13534
0h 5m 16s,13534,655,1247,374437,13534
0h 5m 17s,13536,3558,1709,377995,13536
0h 5m 18s,13536,710,1509,378705,13536
0h 5m 19s,13536,1442,1496,380147,13536
0h 5m 20s,13536,2001,1597,382148,13536
0h 5m 21s,13536,1850,1648,383998,13536
0h 5m 22s,13545,579,1434,384577,13536
0h 5m 23s,13545,1584,1464,386161,13545
0h 5m 24s,13547,1906,1552,388067,13547
0h 5m 25s,13547,0,1242,388067,13547
0h 5m 26s,13547,550,1104,388617,13547
0h 5m 27s,13547,678,1019,389295,13547
0h 5m 28s,13547,1798,1175,391093,13547
0h 5m 29s,13547,493,1039,391586,13547
0h 5m 30s,13547,1283,1088,392869,13547
0h 5m 31s,13547,1357,1142,394226,13547
0h 5m 32s,13547,1047,1123,395273,13547
0h 5m 33s,13547,697,1038,395970,13547
0h 5m 34s,13547,1286,1088,397256,13547
0h 5m 35s,13547,1305,1131,398561,13547
0h 5m 36s,13547,2615,1428,401176,13547
0h 5m 37s,13547,1290,1400,402466,13547
0h 5m 38s,13547,1875,1495,404341,13547
0h 5m 39s,13547,773,1351,405114,13547
0h 5m 40s,13547,1246,1330,406360,13547
0h 5m 41s,13547,1426,1349,407786,13547
0h 5m 42s,13548,2243,1528,410029,13548
0h 5m 43s,13548,657,1354,410686,13548
0h 5m 44s,13548,0,1083,410686,13548
0h 5m 45s,13548,2059,1278,412745,13548
0h 5m 46s,13548,1543,1331,414288,13548
0h 5m 47s,13548,691,1203,414979,13548
0h 5m 48s,13548,690,1100,415669,13548
0h 5m 49s,13548,361,952,416030,13548
0h 5m 50s,13548,1405,1043,417435,13548
0h 5m 51s,13548,776,990,418211,13548
0h 5m 52s,13548,0,792,418211,13548
0h 5m 53s,13548,1430,920,419641,13548
0h 5m 54s,13548,1699,1076,421340,13548
0h 5m 55s,13551,1395,1140,422735,13551
0h 5m 56s,13551,1170,1146,423905,13551
0h 5m 57s,13551,1104,1138,425009,13551
0h 5m 58s,13551,1923,1295,426932,13551
0h 5m 59s,13551,1778,1392,428710,13551
0h 6m 0s,13552,2972,1708,431682,13551
0h 6m 1s,13552,526,1472,432208,13552
0h 6m 2s,13552,1625,1503,433833,13552
0h 6m 3s,13552,0,1202,433833,13552
0h 6m 4s,13552,665,1095,434498,13552
0h 6m 5s,13552,1559,1188,436057,13552
0h 6m 6s,13552,1350,1220,437407,13552
0h 6m 7s,13552,768,1130,438175,13552
0h 6m 8s,13555,2452,1394,440627,13555
0h 6m 9s,13555,670,1249,441297,13555
0h 6m 10s,13555,1399,1279,442696,13555
0h 6m 11s,13555,1810,1385,444506,13555
0h 6m 12s,13555,2826,1673,447332,13555
0h 6m 13s,13555,1405,1619,448737,13555
0h 6m 14s,13555,580,1411,449317,13555
0h 6m 15s,13555,939,1317,450256,13555
0h 6m 16s,13555,1450,1344,451706,13555
0h 6m 17s,13555,430,1161,452136,13555
0h 6m 18s,13555,1333,1195,453469,13555
0h 6m 19s,13555,0,956,453469,13555
0h 6m 20s,13555,2053,1175,455522,13555
0h 6m 21s,13555,1983,1337,457505,13555
0h 6m 22s,13555,607,1191,458112,13555
0h 6m 23s,13555,1943,1341,460055,13555
0h 6m 24s,13556,868,1246,460923,13556
0h 6m 25s,13556,1457,1288,462380,13556
0h 6m 26s,13563,624,1155,463004,13556
0h 6m 27s,13563,2285,1381,465289,13563
0h 6m 28s,13563,1174,1340,466463,13563
0h 6m 29s,13563,0,1072,466463,13563
0h 6m 30s,13563,3208,1499,469671,13563
0h 6m 31s,13563,1439,1487,471110,13563
0h 6m 32s,13563,1542,1498,472652,13563
0h 6m 33s,13563,897,1378,473549,13563
0h 6m 34s,13563,1775,1457,475324,13563
0h 6m 35s,13563,1422,1450,476746,13563
0h 6m 36s,13565,1218,1404,477964,13565
0h 6m 37s,13565,0,1123,477964,13565
0h 6m 38s,13565,542,1007,478506,13565
0h 6m 40s,13565,626,931,479132,13565
0h 6m 41s,13565,2909,1327,482041,13565
0h 6m 42s,13565,1812,1424,483853,13565
0h 6m 43s,13565,3083,1756,486936,13565
0h 6m 44s,13565,1322,1669,488258,13565
0h 6m 45s,13565,607,1457,488865,13565
0h 6m 46s,14081,1003,1366,489868,13565
0h 6m 47s,14081,1356,1364,491224,14081
0h 6m 48s,14081,422,1176,491646,14081
0h 6m 49s,14081,500,1041,492146,14081
0h 6m 50s,14081,1323,1097,493469,14081
0h 6m 51s,14081,2716,1421,496185,14081
0h 6m 52s,14081,1365,1410,497550,14081
0h 6m 53s,14084,1125,1353,498675,14084
0h 6m 54s,14084,1208,1324,499883,14084
0h 6m 55s,14084,1136,1286,501019,14084
0h 6m 56s,14084,852,1199,501871,14084
0h 6m 57s,14084,0,959,501871,14084
0h 6m 58s,14084,1398,1047,503269,14084
0h 6m 59s,14084,1386,1115,504655,14084
0h 7m 0s,14084,1388,1170,506043,14084
0h 7m 1s,14084,1957,1327,508000,14084
0h 7m 2s,14085,1032,1268,509032,14085
0h 7m 3s,14085,421,1099,509453,14085
0h 7m 4s,14085,2218,1323,511671,14085
0h 7m 5s,14085,1495,1357,513166,14085
0h 7m 6s,14085,1072,1300,514238,14085
0h 7m 7s,14086,1420,1324,515658,14086
0h 7m 8s,14086,960,1251,516618,14086
0h 7m 9s,14088,720,1145,517338,14086
0h 7m 10s,14088,579,1032,517917,14088
0h 7m 11s,14088,2712,1368,520629,14088
0h 7m 12s,14088,719,1238,521348,14088
0h 7m 13s,14088,1395,1269,522743,14088
0h 7m 14s,14088,1906,1396,524649,14088
0h 7m 15s,14088,1413,1399,526062,14088
0h 7m 16s,14089,0,1119,526062,14088
0h 7m 17s,14089,1436,1182,527498,14089
0h 7m 18s,14089,3274,1600,530772,14089
0h 7m 19s,14089,2816,1843,533588,14089
0h 7m 20s,14089,1090,1692,534678,14089
0h 7m 21s,14089,1832,1720,536510,14089
0h 7m 22s,14089,1599,1696,538109,14089
0h 7m 23s,14089,785,1514,538894,14089
0h 7m 24s,14089,827,1377,539721,14089
0h 7m 25s,14089,467,1195,540188,14089
0h 7m 26s,14089,663,1089,540851,14089
0h 7m 27s,14089,1286,1128,542137,14089
0h 7m 28s,14089,885,1079,543022,14089
0h 7m 29s,14089,1312,1126,544334,14089
0h 7m 30s,14089,536,1008,544870,14089
0h 7m 31s,14089,1066,1020,545936,14089
0h 7m 32s,14089,600,936,546536,14089
0h 7m 33s,14089,1903,1129,548439,14089
0h 7m 34s,14089,1224,1148,549663,14089
0h 7m 35s,14089,807,1080,550470,14089
0h 7m 36s,14089,1578,1180,552048,14089
0h 7m 37s,14089,2572,1458,554620,14089
0h 7m 38s,14114,720,1310,555340,14089
0h 7m 39s,14114,3713,1791,559053,14114
0h 7m 40s,14114,521,1537,559574,14114
0h 7m 41s,14114,1401,1510,560975,14114
0h 7m 42s,14114,2049,1618,563024,14114
0h 7m 43s,14114,0,1294,563024,14114
0h 7m 44s,14114,1194,1274,564218,14114
0h 7m 45s,14114,1923,1404,566141,14114
0h 7m 46s,14114,0,1123,566141,14114
0h 7m 47s,14114,2689,1436,568830,14114
0h 7m 48s,14114,1419,1433,570249,14114
0h 7m 49s,14114,498,1246,570747,14114
0h 7m 50s,14114,862,1169,571609,14114
0h 7m 51s,14114,0,935,571609,14114
0h 7m 52s,14114,1984,1145,573593,14114
0h 7m 53s,14114,764,1069,574357,14114
0h 7m 54s,14114,760,1007,575117,14114
0h 7m 55s,14116,634,932,575751,14114
0h 7m 56s,14116,3177,1381,578928,14116
0h 7m 57s,14116,756,1256,579684,14116
0h 7m 58s,14116,709,1147,580393,14116
0h 7m 59s,14116,1994,1316,582387,14116
0h 8m 0s,14116,1991,1451,584378,14116
0h 8m 1s,14116,1403,1441,585781,14116
0h 8m 2s,14116,332,1219,586113,14116
0h 8m 3s,14117,684,1112,586797,14117
0h 8m 4s,14117,0,890,586797,14117
0h 8m 5s,14117,1926,1097,588723,14117
0h 8m 6s,14117,1234,1124,589957,14117
0h 8m 7s,14117,675,1034,590632,14117
0h 8m 8s,14117,1539,1135,592171,14117
0h 8m 9s,14117,1930,1294,594101,14117
0h 8m 10s,14117,1074,1250,595175,14117
0h 8m 11s,14117,1258,1252,596433,14117
0h 8m 12s,14117,0,1002,596433,14117
0h 8m 13s,14117,0,802,596433,14117
0h 8m 14s,14117,721,786,597154,14117
0h 8m 15s,14117,3389,1307,600543,14117
0h 8m 16s,14117,0,1046,600543,14117
0h 8m 17s,14117,1899,1217,602442,14117
0h 8m 18s,14117,1159,1205,603601,14117
0h 8m 19s,14117,2611,1486,606212,14117
0h 8m 20s,14117,653,1319,606865,14117
0h 8m 21s,14117,0,1055,606865,14117
0h 8m 22s,14117,3106,1465,609971,14117
0h 8m 23s,14117,1797,1531,611768,14117
0h 8m 24s,14117,1144,1454,612912,14117
0h 8m 25s,14117,2028,1569,614940,14117
0h 8m 26s,14117,753,1406,615693,14117
0h 8m 27s,14117,489,1223,616182,14117
0h 8m 28s,14117,1596,1298,617778,14117
0h 8m 29s,14117,0,1038,617778,14117
0h 8m 30s,14117,1877,1206,619655,14117
0h 8m 31s,14117,0,965,619655,14117
0h 8m 32s,14117,1685,1109,621340,14117
0h 8m 33s,14117,1553,1198,622893,14117
0h 8m 34s,14117,1547,1268,624440,14117
0h 8m 35s,14117,0,1014,624440,14117
0h 8m 36s,14117,498,911,624938,14117
0h 8m 37s,14117,1193,967,626131,14117
0h 8m 38s,14117,2066,1187,628197,14117
0h 8m 39s,14117,609,1071,628806,14117
0h 8m 40s,14117,471,951,629277,14117
0h 8m 41s,14117,678,896,629955,14117
0h 8m 42s,14117,1177,952,631132,14117
0h 8m 43s,14117,1896,1141,633028,14117
0h 8m 44s,14117,1229,1159,634257,14117
0h 8m 45s,14117,1082,1144,635339,14117
0h 8m 46s,14117,2581,1431,637920,14117
0h 8m 48s,14117,0,1145,637920,14117
0h 8m 49s,14117,989,1114,638909,14117
0h 8m 50s,14117,1191,1129,640100,14117
0h 8m 51s,14117,681,1039,640781,14117
0h 8m 52s,14117,2215,1274,642996,14117
0h 8m 53s,14117,535,1126,643531,14117
0h 8m 54s,14117,1894,1280,645425,14117
0h 8m 55s,14117,681,1160,646106,14117
0h 8m 56s,14117,1478,1224,647584,14117
0h 8m 57s,14117,1112,1202,648696,14117
0h 8m 58s,14117,1801,1322,650497,14117
0h 8m 59s,14117,2367,1531,652864,14117
0h 9m 0s,14117,1337,1492,654201,14117
0h 9m 1s,14117,1615,1517,655816,14117
0h 9m 2s,14117,1207,1455,657023,14117
0h 9m 3s,14117,0,1164,657023,14117
0h 9m 4s,14117,679,1067,657702,14117
0h 9m 5s,14117,1097,1073,658799,14117
0h 9m 6s,14117,1939,1246,660738,14117
0h 9m 7s,14117,0,997,660738,14117
0h 9m 8s,14117,1609,1119,662347,14117
0h 9m 9s,14119,1134,1122,663481,14119
0h 9m 10s,14119,1466,1191,664947,14119
0h 9m 11s,14119,0,953,664947,14119
0h 9m 12s,14119,1911,1145,666858,14119
0h 9m 13s,14119,931,1102,667789,14119
0h 9m 14s,14119,1113,1104,668902,14119
0h 9m 15s,14119,1232,1130,670134,14119
0h 9m 16s,14119,1445,1193,671579,14119
0h 9m 17s,14119,586,1072,672165,14119
0h 9m 18s,14119,1172,1092,673337,14119
0h 9m 19s,14119,2197,1313,675534,14119
0h 9m 20s,14119,1058,1262,676592,14119
0h 9m 21s,14138,1726,1355,678318,14138
0h 9m 22s,14138,1126,1309,679444,14138
0h 9m 23s,14138,1566,1360,681010,14138
0h 9m 24s,14138,2066,1501,683076,14138
0h 9m 25s,14138,1351,1471,684427,14138
0h 9m 26s,14138,1376,1452,685803,14138
0h 9m 27s,14138,0,1162,685803,14138
0h 9m 28s,14138,2341,1398,688144,14138
0h 9m 29s,14138,1386,1396,689530,14138
0h 9m 30s,14138,704,1258,690234,14138
0h 9m 31s,14138,443,1095,690677,14138
0h 9m 32s,14138,0,876,690677,14138
0h 9m 33s,14138,1401,981,692078,14138
0h 9m 34s,14138,1141,1013,693219,14138
0h 9m 35s,14138,3358,1482,696577,14138
0h 9m 36s,14138,919,1369,697496,14138
0h 9m 37s,14138,761,1247,698257,14138
0h 9m 38s,14138,1197,1237,699454,14138
0h 9m 39s,14149,1317,1253,700771,14149
0h 9m 40s,14149,2656,1534,703427,14149
0h 9m 41s,14149,822,1392,704249,14149
0h 9m 42s,14149,1930,1500,706179,14149
0h 9m 43s,14149,442,1288,706621,14149
0h 9m 44s,14149,1304,1291,707925,14149
0h 9m 45s,14149,2701,1573,710626,14149
0h 9m 46s,14149,733,1405,711359,14149
0h 9m 47s,14149,1283,1381,712642,14149
0h 9m 48s,14149,1318,1368,713960,14149
0h 9m 49s,14149,1399,1374,715359,14149
0h 9m 50s,14149,1548,1409,716907,14149
0h 9m 51s,14149,535,1234,717442,14149
0h 9m 52s,14149,0,987,717442,14149
0h 9m 53s,14149,853,960,718295,14149
0h 9m 54s,14149,1418,1052,719713,14149
0h 9m 55s,14149,2072,1256,721785,14149
0h 9m 56s,14149,1544,1314,723329,14149
0h 9m 57s,14149,1101,1271,724430,14149
0h 9m 58s,14149,498,1116,724928,14149
0h 9m 59s,14149,3358,1564,728286,14149
0h 10m 0s,14150,697,1391,728983,14149
0h 10m 1s,14150,0,1113,728983,14149
0h 10m 2s,14150,2173,1325,731156,14150
0h 10m 3s,14150,0,1060,731156,14150
0h 10m 4s,14150,1448,1138,732604,14150
0h 10m 5s,14150,519,1014,733123,14150
0h 10m 6s,14150,1397,1091,734520,14150
0h 10m 7s,14150,2015,1276,736535,14150
0h 10m 8s,14150,1676,1356,738211,14150
0h 10m 9s,14150,1646,1414,739857,14150
0h 10m 10s,14150,778,1287,740635,14150
0h 10m 11s,14178,1512,1332,742147,14178
0h 10m 12s,14180,1275,1321,743422,14180
0h 10m 13s,14183,1450,1347,744872,14183
0h 10m 14s,14183,1832,1444,746704,14183
0h 10m 15s,14183,775,1310,747479,14183
0h 10m 16s,14183,0,1048,747479,14183
0h 10m 17s,14183,1240,1086,748719,14183
0h 10m 18s,14183,410,951,749129,14183
0h 10m 19s,14183,0,761,749129,14183
0h 10m 20s,14183,750,759,749879,14183
0h 10m 21s,14183,2277,1063,752156,14183
0h 10m 22s,14185,2026,1256,754182,14183
0h 10m 23s,14185,0,1005,754182,14183
0h 10m 24s,14185,1815,1167,755997,14185
0h 10m 25s,14185,1013,1136,757010,14185
0h 10m 26s,14185,1177,1144,758187,14185
0h 10m 27s,14185,678,1051,758865,14185
0h 10m 28s,14185,619,965,759484,14185
0h 10m 29s,14185,3300,1432,762784,14185
0h 10m 30s,14185,1684,1482,764468,14185
0h 10m 31s,14185,698,1325,765166,14185
0h 10m 32s,14185,1034,1267,766200,14185
0h 10m 33s,14185,2232,1460,768432,14185
0h 10m 34s,14185,1435,1455,769867,14185
0h 10m 35s,14185,637,1291,770504,14185
0h 10m 36s,14185,3309,1695,773813,14185
0h 10m 37s,14185,0,1356,773813,14185
0h 10m 38s,14185,1322,1349,775135,14185
0h 10m 39s,14185,436,1166,775571,14185
0h 10m 40s,14185,724,1078,776295,14185
0h 10m 41s,14185,2170,1296,778465,14185
0h 10m 42s,14185,671,1171,779136,14185
0h 10m 43s,14185,1282,1193,780418,14185
0h 10m 44s,14185,1963,1347,782381,14185
0h 10m 45s,14185,0,1078,782381,14185
0h 10m 46s,14185,547,972,782928,14185
0h 10m 47s,14185,3555,1489,786483,14185
0h 10m 48s,14185,2011,1593,788494,14185
0h 10m 49s,14185,636,1402,789130,14185
0h 10m 50s,14185,1953,1512,791083,14185
0h 10m 51s,14185,0,1210,791083,14185
0h 10m 52s,14185,591,1086,791674,14185
0h 10m 53s,14185,2193,1307,793867,14185
0h 10m 54s,14185,595,1165,794462,14185
0h 10m 55s,14185,0,932,794462,14185
0h 10m 57s,14185,724,890,795186,14185
0h 10m 58s,14185,1972,1106,797158,14185
0h 10m 59s,14185,1599,1205,798757,14185
0h 11m 0s,14185,1323,1229,800080,14185
0h 11m 1s,14185,1392,1262,801472,14185
0h 11m 2s,14185,1373,1284,802845,14185
0h 11m 3s,14185,1406,1308,804251,14185
0h 11m 4s,14185,593,1165,804844,14185
0h 11m 5s,14185,598,1052,805442,14185
0h 11m 6s,14185,726,987,806168,14185
0h 11m 7s,14185,1301,1050,807469,14185
0h 11m 8s,14185,2169,1274,809638,14185
0h 11m 9s,14185,2137,1447,811775,14185
0h 11m 10s,14185,0,1158,811775,14185
0h 11m 11s,14185,1196,1166,812971,14185
0h 11m 12s,14185,1932,1319,814903,14185
0h 11m 13s,14185,1825,1420,816728,14185
0h 11m 14s,14185,1054,1347,817782,14185
0h 11m 15s,14185,2075,1493,819857,14185
0h 11m 16s,14185,1369,1468,821226,14185
0h 11m 17s,14185,569,1288,821795,14185
0h 11m 18s,14185,0,1030,821795,14185
0h 11m 19s,14185,0,824,821795,14185
0h 11m 20s,14188,1150,889,822945,14185
0h 11m 21s,14188,0,711,822945,14185
0h 11m 22s,14188,3340,1237,826285,14188
0h 11m 23s,14188,1948,1379,828233,14188
0h 11m 24s,14191,1311,1365,829544,14191
0h 11m 25s,14191,1906,1473,831450,14191
0h 11m 26s,14191,1056,1390,832506,14191
0h 11m 27s,14191,0,1112,832506,14191
0h 11m 28s,14191,1175,1125,833681,14191
0h 11m 29s,14191,2169,1334,835850,14191
0h 11m 30s,14191,1167,1301,837017,14191
0h 11m 31s,14191,1168,1274,838185,14191
0h 11m 32s,14191,0,1019,838185,14191
0h 11m 33s,14191,1335,1082,839520,14191
0h 11m 34s,14191,711,1008,840231,14191
0h 11m 35s,14191,2252,1257,842483,14191
0h 11m 36s,14191,1254,1256,843737,14191
0h 11m 37s,14191,487,1102,844224,14191
0h 11m 38s,14191,1258,1133,845482,14191
0h 11m 39s,14191,1202,1147,846684,14191
0h 11m 40s,14191,1856,1289,848540,14191
0h 11m 41s,14191,0,1031,848540,14191
0h 11m 42s,14191,546,934,849086,14191
0h 11m 43s,14191,1548,1057,850634,14191
0h 11m 44s,14191,3259,1497,853893,14191
0h 11m 45s,14191,550,1308,854443,14191
0h 11m 46s,14191,806,1208,855249,14191
0h 11m 47s,14191,675,1101,855924,14191
0h 11m 48s,14191,1766,1234,857690,14191
0h 11m 49s,14191,1460,1279,859150,14191
0h 11m 50s,14191,749,1173,859899,14191
0h 11m 51s,14198,2762,1491,862661,14198
0h 11m 52s,14198,626,1318,863287,14198
0h 11m 53s,14198,1197,1294,864484,14198
0h 11m 54s,14198,614,1158,865098,14198
0h 11m 55s,14198,1882,1303,866980,14198
0h 11m 56s,14198,765,1195,867745,14198
0h 11m 57s,14198,1613,1279,869358,14198
0h 11m 58s,14198,0,1023,869358,14198
0h 11m 59s,14198,696,958,870054,14198
0h 12m 0s,14198,786,924,870840,14198
0h 12m 1s,14198,637,867,871477,14198
0h 12m 2s,14198,1357,965,872834,14198
0h 12m 3s,14198,1382,1048,874216,14198
0h 12m 4s,14198,0,838,874216,14198
0h 12m 5s,14198,2649,1200,876865,14198
0h 12m 6s,14198,906,1141,877771,14198
0h 12m 7s,14198,0,913,877771,14198
0h 12m 8s,14198,2319,1194,880090,14198
0h 12m 9s,14198,1275,1210,881365,14198
0h 12m 10s,14198,516,1071,881881,14198
0h 12m 11s,14198,1263,1109,883144,14198
0h 12m 12s,14198,1768,1241,884912,14198
0h 12m 13s,14198,533,1099,885445,14198
0h 12m 14s,14198,0,879,885445,14198
0h 12m 15s,14198,1801,1063,887246,14198
0h 12m 16s,14271,2402,1331,889648,14198
0h 12m 17s,14271,0,1065,889648,14198
0h 12m 18s,14271,2500,1352,892148,14271
0h 12m 19s,14271,531,1188,892679,14271
0h 12m 20s,14271,757,1102,893436,14271
0h 12m 21s,14271,1910,1264,895346,14271
0h 12m 22s,14271,1445,1300,896791,14271
0h 12m 23s,14271,591,1158,897382,14271
0h 12m 24s,14271,1895,1305,899277,14271
0h 12m 25s,14271,2951,1634,902228,14271
0h 12m 26s,14271,0,1307,902228,14271
0h 12m 27s,14271,784,1202,903012,14271
0h 12m 28s,14271,1050,1172,904062,14271
0h 12m 29s,14271,1909,1319,905971,14271
0h 12m 30s,14271,1190,1293,907161,14271
0h 12m 31s,14271,1608,1356,908769,14271
0h 12m 32s,14271,0,1085,908769,14271
0h 12m 33s,14271,2499,1368,911268,14271
0h 12m 34s,14271,1866,1468,913134,14271
0h 12m 35s,14271,0,1174,913134,14271
0h 12m 36s,14271,1858,1311,914992,14271
0h 12m 37s,14271,616,1172,915608,14271
0h 12m 38s,14271,727,1083,916335,14271
0h 12m 39s,14271,650,996,916985,14271
0h 12m 40s,14271,489,895,917474,14271
0h 12m 41s,14271,712,858,918186,14271
0h 12m 42s,14271,2282,1143,920468,14271
0h 12m 43s,14271,2021,1319,922489,14271
0h 12m 44s,14271,698,1195,923187,14271
0h 12m 45s,14271,674,1091,923861,14271
0h 12m 46s,14271,780,1029,924641,14271
0h 12m 47s,14271,2242,1272,926883,14271
0h 12m 48s,14271,2121,1442,929004,14271
0h 12m 49s,14273,796,1313,929800,14271
0h 12m 50s,14273,873,1225,930673,14273
0h 12m 51s,14273,756,1131,931429,14273
0h 12m 52s,14273,624,1030,932053,14273
0h 12m 53s,14273,522,928,932575,14273
0h 12m 54s,14273,1737,1090,934312,14273
0h 12m 55s,14273,651,1002,934963,14273
0h 12m 56s,14273,1738,1149,936701,14273
0h 12m 57s,14273,781,1075,937482,14273
0h 12m 58s,14273,2221,1304,939703,14273
0h 12m 59s,14273,625,1168,940328,14273
0h 13m 0s,14273,0,934,940328,14273
0h 13m 1s,14273,497,847,940825,14273
0h 13m 2s,14273,2138,1105,942963,14273
0h 13m 3s,14273,578,1000,943541,14273
0h 13m 4s,14273,1885,1177,945426,14273
0h 13m 5s,14273,0,942,945426,14273
0h 13m 6s,14273,2807,1315,948233,14273
0h 13m 7s,14273,1314,1315,949547,14273
0h 13m 8s,14273,1186,1289,950733,14273
0h 13m 9s,14273,1621,1355,952354,14273
0h 13m 10s,14273,2051,1494,954405,14273
0h 13m 11s,14273,807,1357,955212,14273
0h 13m 12s,14273,1395,1365,956607,14273
0h 13m 13s,14273,0,1092,956607,14273
0h 13m 14s,14273,1477,1169,958084,14273
0h 13m 15s,14273,1877,1311,959961,14273
0h 13m 16s,14273,1533,1355,961494,14273
0h 13m 17s,14273,587,1201,962081,14273
0h 13m 18s,14273,1526,1266,963607,14273
0h 13m 19s,14273,757,1164,964364,14273
0h 13m 20s,14273,668,1065,965032,14273
0h 13m 21s,14273,1237,1099,966269,14273
0h 13m 23s,14273,1091,1097,967360,14273
0h 13m 24s,14273,1628,1203,968988,14273
0h 13m 25s,14273,1187,1200,970175,14273
0h 13m 26s,14273,1736,1307,971911,14273
0h 13m 27s,14273,1080,1262,972991,14273
0h 13m 28s,14273,1124,1234,974115,14273
0h 13m 29s,14273,688,1125,974803,14273
0h 13m 30s,14273,1201,1140,976004,14273
0h 13m 31s,14273,1175,1147,977179,14273
0h 13m 32s,14273,1329,1183,978508,14273
0h 13m 33s,14273,2617,1470,981125,14273
0h 13m 34s,14273,1234,1423,982359,14273
0h 13m 35s,14273,831,1305,983190,14273
0h 13m 36s,14273,2533,1551,985723,14273
0h 13m 37s,14273,1306,1502,987029,14273
0h 13m 38s,14273,0,1202,987029,14273
0h 13m 39s,14273,481,1058,987510,14273
0h 13m 40s,14273,1843,1215,989353,14273
0h 13m 41s,14273,663,1105,990016,14273
0h 13m 42s,14273,700,1024,990716,14273
0h 13m 43s,14273,1244,1068,991960,14273
0h 13m 44s,14275,2269,1308,994229,14275
0h 13m 45s,14275,685,1183,994914,14275
0h 13m 46s,14275,0,946,994914,14275
0h 13m 47s,14275,2015,1160,996929,14275
0h 13m 48s,14275,2858,1500,999787,14275
0h 13m 49s,14275,0,1200,999787,14275
0h 13m 50s,14275,1541,1268,1001328,14275
0h 13m 51s,14275,844,1183,1002172,14275
0h 13m 52s,14275,0,946,1002172,14275
0h 13m 53s,14275,0,757,1002172,14275
0h 13m 54s,14275,1506,907,1003678,14275
0h 13m 55s,14275,1135,953,1004813,14275
0h 13m 56s,14275,1165,995,1005978,14275
0h 13m 57s,14275,0,796,1005978,14275
0h 13m 58s,14275,658,768,1006636,14275
0h 13m 59s,14275,712,757,1007348,14275
0h 14m 0s,14275,0,606,1007348,14275
0h 14m 1s,14275,3252,1135,1010600,14275
0h 14m 2s,14275,1244,1157,1011844,14275
0h 14m 3s,14275,584,1042,1012428,14275
0h 14m 4s,14275,1401,1114,1013829,14275
0h 14m 5s,14275,711,1033,1014540,14275
0h 14m 6s,14275,760,978,1015300,14275
0h 14m 7s,14275,0,782,1015300,14275
0h 14m 8s,14275,2095,1045,1017395,14275
0h 14m 9s,14275,0,836,1017395,14275
0h 14m 10s,14275,2713,1211,1020108,14275
0h 14m 11s,14275,1313,1231,1021421,14275
0h 14m 12s,14275,476,1080,1021897,14275
0h 14m 13s,14275,1991,1262,1023888,14275
0h 14m 14s,14275,1196,1249,1025084,14275
0h 14m 15s,14275,0,999,1025084,14275
0h 14m 16s,14275,2658,1331,1027742,14275
0h 14m 17s,14275,2207,1506,1029949,14275
0h 14m 18s,14278,1523,1509,1031472,14275
0h 14m 19s,14278,1029,1413,1032501,14278
0h 14m 20s,14278,1423,1415,1033924,14278
0h 14m 21s,14278,1192,1370,1035116,14278
0h 14m 22s,14278,1831,1462,1036947,14278
0h 14m 23s,14278,2144,1598,1039091,14278
0h 14m 24s,14278,737,1426,1039828,14278
0h 14m 25s,14278,0,1141,1039828,14278
0h 14m 26s,14278,648,1042,1040476,14278
0h 14m 27s,14278,1406,1115,1041882,14278
0h 14m 28s,14278,1586,1209,1043468,14278
0h 14m 29s,14278,1367,1241,1044835,14278
0h 14m 30s,14278,0,993,1044835,14278
0h 14m 31s,14278,928,980,1045763,14278
0h 14m 32s,14278,755,935,1046518,14278
0h 14m 33s,14278,0,748,1046518,14278
0h 14m 34s,14278,1404,879,1047922,14278
0h 14m 35s,14278,1756,1054,1049678,14278
0h 14m 36s,14278,655,974,1050333,14278
0h 14m 37s,14278,473,874,1050806,14278
0h 14m 38s,14278,645,828,1051451,14278
0h 14m 39s,14278,1213,905,1052664,14278
0h 14m 40s,14278,3178,1360,1055842,14278
0h 14m 41s,14278,674,1223,1056516,14278
0h 14m 42s,14278,1000,1178,1057516,14278
0h 14m 43s,14278,1876,1318,1059392,14278
0h 14m 44s,14278,1560,1366,1060952,14278
0h 14m 45s,14278,1004,1294,1061956,14278
0h 14m 46s,14278,1681,1371,1063637,14278
0h 14m 47s,14278,611,1219,1064248,14278
0h 14m 48s,14278,1762,1328,1066010,14278
0h 14m 49s,14278,0,1062,1066010,14278
0h 14m 50s,14278,680,986,1066690,14278
0h 14m 51s,14278,747,938,1067437,14278
0h 14m 52s,14278,1251,1001,1068688,14278
0h 14m 53s,14278,719,945,1069407,14278
0h 14m 54s,14278,2062,1168,1071469,14278
0h 14m 55s,14278,2222,1379,1073691,14278
0h 14m 56s,14278,1924,1488,1075615,14278
0h 14m 57s,14278,1368,1464,1076983,14278
0h 14m 58s,14278,1320,1435,1078303,14278
0h 14m 59s,14278,1280,1404,1079583,14278
0h 15m 0s,14278,1045,1332,1080628,14278
0h 15m 1s,14278,611,1188,1081239,14278
0h 15m 2s,14278,1844,1319,1083083,14278
0h 15m 3s,14278,1478,1351,1084561,14278
0h 15m 4s,14278,0,1081,1084561,14278
0h 15m 5s,14278,2191,1303,1086752,14278
0h 15m 6s,14278,1461,1335,1088213,14278
0h 15m 7s,14278,1214,1311,1089427,14278
0h 15m 8s,14280,1361,1321,1090788,14280
0h 15m 9s,14280,2256,1508,1093044,14280
0h 15m 10s,14280,1799,1566,1094843,14280
0h 15m 11s,14280,456,1344,1095299,14280
0h 15m 12s,14280,1096,1294,1096395,14280
0h 15m 13s,14280,586,1152,1096981,14280
0h 15m 14s,14280,606,1043,1097587,14280
0h 15m 15s,14280,0,834,1097587,14280
0h 15m 16s,14280,2634,1194,1100221,14280
0h 15m 17s,14280,1144,1184,1101365,14280
0h 15m 18s,14280,0,947,1101365,14280
0h 15m 19s,14280,1925,1143,1103290,14280
0h 15m 20s,14280,0,914,1103290,14280
0h 15m 21s,14280,1562,1044,1104852,14280
0h 15m 22s,14280,1299,1095,1106151,14280
0h 15m 23s,14280,689,1014,1106840,14280
0h 15m 24s,14280,581,927,1107421,14280
0h 15m 25s,14280,987,939,1108408,14280
0h 15m 26s,14280,648,881,1109056,14280
0h 15m 27s,14280,1886,1082,1110942,14280
0h 15m 28s,14280,1096,1085,1112038,14280
0h 15m 29s,14280,538,976,1112576,14280
0h 15m 30s,14280,0,781,1112576,14280
0h 15m 31s,14280,0,625,1112576,14280
0h 15m 32s,14280,0,500,1112576,14280
0h 15m 33s,14280,2225,845,1114801,14280
0h 15m 34s,14280,3193,1315,1117994,14280
0h 15m 35s,14280,1320,1316,1119314,14280
0h 15m 37s,14280,767,1206,1120081,14280
0h 15m 38s,14280,1680,1301,1121761,14280
0h 15m 39s,14280,714,1184,1122475,14280
0h 15m 40s,14280,1228,1193,1123703,14280
0h 15m 41s,14280,1099,1174,1124802,14280
0h 15m 42s,14280,2728,1485,1127530,14280
0h 15m 43s,14280,1202,1428,1128732,14280
0h 15m 44s,14280,1256,1394,1129988,14280
0h 15m 45s,14280,1841,1483,1131829,14280
0h 15m 46s,14280,1071,1401,1132900,14280
0h 15m 47s,14280,1971,1515,1134871,14280
0h 15m 48s,14280,848,1382,1135719,14280
0h 15m 49s,14280,545,1215,1136264,14280
0h 15m 50s,14280,1478,1268,1137742,14280
0h 15m 51s,14280,706,1156,1138448,14280
0h 15m 52s,14280,0,925,1138448,14280
0h 15m 53s,14280,1835,1107,1140283,14280
0h 15m 54s,14280,1298,1145,1141581,14280
0h 15m 55s,14280,747,1065,1142328,14280
0h 15m 56s,14280,1635,1179,1143963,14280
0h 15m 57s,14280,469,1037,1144432,14280
0h 15m 58s,14280,1345,1099,1145777,14280
0h 15m 59s,14280,1008,1081,1146785,14280
0h 16m 0s,14280,1585,1182,1148370,14280
0h 16m 1s,14280,0,946,1148370,14280
0h 16m 2s,14280,2376,1232,1150746,14280
0h 16m 3s,14280,1384,1262,1152130,14280
0h 16m 4s,14280,1369,1283,1153499,14280
0h 16m 5s,14280,667,1160,1154166,14280
0h 16m 6s,14280,1334,1195,1155500,14280
0h 16m 7s,14280,2929,1542,1158429,14280
0h 16m 8s,14280,0,1234,1158429,14280
0h 16m 9s,14280,675,1122,1159104,14280
0h 16m 10s,14280,417,981,1159521,14280
0h 16m 11s,14280,2270,1239,1161791,14280
0h 16m 12s,14280,659,1123,1162450,14280
0h 16m 13s,14281,1348,1168,1163798,14280
0h 16m 14s,14281,1563,1247,1165361,14281
0h 16m 15s,14281,699,1137,1166060,14281
0h 16m 16s,14281,1148,1139,1167208,14281
0h 16m 17s,14281,708,1053,1167916,14281
0h 16m 18s,14281,868,1016,1168784,14281
0h 16m 19s,14281,1105,1034,1169889,14281
0h 16m 20s,14281,700,967,1170589,14281
0h 16m 21s,14281,2065,1187,1172654,14281
0h 16m 22s,14281,1395,1229,1174049,14281
0h 16m 23s,14283,819,1147,1174868,14281
0h 16m 24s,14283,1554,1228,1176422,14283
0h 16m 25s,14283,1237,1230,1177659,14283
0h 16m 26s,14283,777,1139,1178436,14283
0h 16m 27s,14283,1758,1263,1180194,14283
0h 16m 28s,14283,0,1010,1180194,14283
0h 16m 29s,14283,1432,1094,1181626,14283
0h 16m 30s,14283,1881,1251,1183507,14283
0h 16m 31s,14283,1530,1307,1185037,14283
0h 16m 32s,14283,1329,1311,1186366,14283
0h 16m 33s,14283,556,1160,1186922,14283
0h 16m 34s,14283,2161,1360,1189083,14283
0h 16m 35s,14283,1157,1319,1190240,14283
0h 16m 36s,14283,2009,1457,1192249,14283
0h 16m 37s,14283,3496,1865,1195745,14283
0h 16m 38s,14283,696,1631,1196441,14283
0h 16m 39s,14283,596,1424,1197037,14283
0h 16m 40s,14283,0,1139,1197037,14283
0h 16m 41s,14283,606,1032,1197643,14283
0h 16m 42s,14283,1989,1223,1199632,14283
0h 16m 43s,14283,1402,1259,1201034,14283
0h 16m 44s,14283,608,1129,1201642,14283
0h 16m 45s,14283,631,1029,1202273,14283
0h 16m 46s,14283,0,823,1202273,14283
0h 16m 47s,14283,2612,1181,1204885,14283
0h 16m 48s,14283,648,1074,1205533,14283
0h 16m 49s,14283,549,969,1206082,14283
0h 16m 50s,14283,2566,1288,1208648,14283
0h 16m 51s,14283,570,1144,1209218,14283
0h 16m 52s,14283,0,915,1209218,14283
0h 16m 53s,14283,703,873,1209921,14283
0h 16m 54s,14283,2278,1154,1212199,14283
0h 16m 55s,14283,1920,1307,1214119,14283
0h 16m 56s,14283,0,1046,1214119,14283
0h 16m 57s,14283,2660,1369,1216779,14283
0h 16m 58s,14283,0,1095,1216779,14283
0h 16m 59s,14283,0,876,1216779,14283
0h 17m 0s,14283,519,805,1217298,14283
0h 17m 1s,14283,773,799,1218071,14283
0h 17m 2s,14283,951,829,1219022,14283
0h 17m 3s,14283,1711,1005,1220733,14283
0h 17m 4s,14286,1077,1019,1221810,14286
0h 17m 5s,14286,1382,1092,1223192,14286
0h 17m 6s,14286,1384,1150,1224576,14286
0h 17m 7s,14286,637,1047,1225213,14286
0h 17m 8s,14286,720,982,1225933,14286
0h 17m 9s,14286,2184,1222,1228117,14286
0h 17m 10s,14286,0,978,1228117,14286
0h 17m 11s,14286,1231,1029,1229348,14286
0h 17m 12s,14286,1426,1108,1230774,14286
0h 17m 13s,14289,0,886,1230774,14286
0h 17m 14s,14289,2574,1224,1233348,14289
0h 17m 15s,14289,2119,1403,1235467,14289
0h 17m 16s,14289,0,1122,1235467,14289
0h 17m 17s,14289,473,992,1235940,14289
0h 17m 18s,14289,2419,1277,1238359,14289
0h 17m 19s,14289,0,1022,1238359,14289
0h 17m 20s,14294,2013,1220,1240372,14289
0h 17m 21s,14294,2994,1575,1243366,14294
0h 17m 22s,14294,0,1260,1243366,14294
0h 17m 23s,14294,1945,1397,1245311,14294
0h 17m 24s,14294,1693,1456,1247004,14294
0h 17m 25s,14294,0,1165,1247004,14294
0h 17m 26s,14294,1834,1299,1248838,14294
0h 17m 27s,14294,519,1143,1249357,14294
0h 17m 28s,14294,2339,1382,1251696,14294
0h 17m 29s,14294,624,1230,1252320,14294
0h 17m 30s,14294,498,1084,1252818,14294
0h 17m 31s,14294,1287,1125,1254105,14294
0h 17m 32s,14294,685,1037,1254790,14294
0h 17m 33s,14294,613,952,1255403,14294
0h 17m 34s,14294,1169,995,1256572,14294
0h 17m 35s,14294,803,957,1257375,14294
0h 17m 36s,14294,4498,1665,1261873,14294
0h 17m 37s,14294,929,1518,1262802,14294
0h 17m 38s,14294,1170,1448,1263972,14294
0h 17m 39s,14294,532,1265,1264504,14294
0h 17m 40s,14294,1995,1411,1266499,14294
0h 17m 41s,14294,1226,1374,1267725,14294
0h 17m 42s,14294,1204,1340,1268929,14294
0h 17m 43s,14294,621,1196,1269550,14294
0h 17m 44s,14294,1330,1223,1270880,14294
0h 17m 45s,14294,391,1057,1271271,14294
0h 17m 46s,14294,400,926,1271671,14294
0h 17m 47s,14294,605,862,1272276,14294
0h 17m 48s,14294,1412,972,1273688,14294
0h 17m 49s,14294,2383,1254,1276071,14294
0h 17m 50s,14294,1107,1225,1277178,14294
0h 17m 51s,14294,1199,1220,1278377,14294
0h 17m 52s,14294,1321,1240,1279698,14294
0h 17m 53s,14294,0,992,1279698,14294
0h 17m 54s,14294,1999,1193,1281697,14294
0h 17m 56s,14294,3495,1653,1285192,14294
0h 17m 57s,14294,561,1435,1285753,14294
0h 17m 58s,14294,504,1249,1286257,14294
0h 17m 59s,14294,1653,1330,1287910,14294
0h 18m 0s,14294,1813,1427,1289723,14294
0h 18m 1s,14294,751,1292,1290474,14294
0h 18m 2s,14294,0,1034,1290474,14294
0h 18m 3s,14294,0,827,1290474,14294
0h 18m 4s,14294,0,662,1290474,14294
0h 18m 5s,14294,0,530,1290474,14294
0h 18m 6s,14294,449,514,1290923,14294
0h 18m 7s,14294,1251,661,1292174,14294
0h 18m 8s,14294,0,529,1292174,14294
0h 18m 9s,14294,1881,799,1294055,14294
0h 18m 10s,14294,1238,887,1295293,14294
0h 18m 11s,14294,0,710,1295293,14294
0h 18m 12s,14294,1154,799,1296447,14294
0h 18m 13s,14294,2268,1093,1298715,14294
0h 18m 14s,14294,559,986,1299274,14294
0h 18m 15s,14294,1184,1026,1300458,14294
0h 18m 16s,14294,2054,1232,1302512,14294
0h 18m 17s,14294,2035,1393,1304547,14294
0h 18m 18s,14294,1678,1450,1306225,14294
0h 18m 19s,14294,845,1329,1307070,14294
0h 18m 20s,14294,1969,1457,1309039,14294
0h 18m 21s,14294,1215,1409,1310254,14294
0h 18m 22s,14294,820,1291,1311074,14294
0h 18m 23s,14294,0,1033,1311074,14294
0h 18m 24s,14294,1191,1065,1312265,14294
0h 18m 25s,14294,845,1021,1313110,14294
0h 18m 26s,14294,596,936,1313706,14294
0h 18m 27s,14294,2028,1154,1315734,14294
0h 18m 28s,14294,1238,1171,1316972,14294
0h 18m 29s,14294,1253,1187,1318225,14294
0h 18m 30s,14294,1572,1264,1319797,14294
0h 18m 31s,14294,1137,1239,1320934,14294
0h 18m 32s,14294,1035,1198,1321969,14294
0h 18m 33s,14294,1260,1210,1323229,14294
0h 18m 34s,14294,1615,1291,1324844,14294
0h 18m 35s,14294,1236,1280,1326080,14294
0h 18m 36s,14294,1232,1270,1327312,14294
0h 18m 37s,14294,781,1172,1328093,14294
0h 18m 38s,14294,441,1026,1328534,14294
0h 18m 39s,14294,646,950,1329180,14294
0h 18m 40s,14294,1777,1115,1330957,14294
0h 18m 41s,14294,2043,1301,1333000,14294
0h 18m 42s,14294,544,1150,1333544,14294
0h 18m 43s,14294,477,1015,1334021,14294
0h 18m 44s,14295,678,948,1334699,14295
0h 18m 45s,14295,1826,1124,1336525,14295
0h 18m 46s,14295,1120,1123,1337645,14295
0h 18m 47s,14295,0,898,1337645,14295
0h 18m 48s,14295,532,825,1338177,14295
0h 18m 49s,14295,2279,1116,1340456,14295
0h 18m 50s,14295,1011,1095,1341467,14295
0h 18m 51s,14295,0,876,1341467,14295
0h 18m 52s,14295,707,842,1342174,14295
0h 18m 53s,14295,1343,942,1343517,14295
0h 18m 54s,14295,1226,999,1344743,14295
0h 18m 55s,14295,1304,1060,1346047,14295
0h 18m 56s,14295,1998,1248,1348045,14295
0h 18m 57s,14295,1357,1270,1349402,14295
0h 18m 58s,14295,509,1118,1349911,14295
0h 18m 59s,14295,686,1032,1350597,14295
0h 19m 0s,14295,1899,1205,1352496,14295
0h 19m 1s,14295,575,1079,1353071,14295
0h 19m 2s,14295,2418,1347,1355489,14295
0h 19m 3s,14295,1433,1364,1356922,14295
0h 19m 4s,14295,2993,1690,1359915,14295
0h 19m 5s,14295,0,1352,1359915,14295
0h 19m 6s,14295,0,1082,1359915,14295
0h 19m 7s,14295,2011,1268,1361926,14295
0h 19m 8s,14295,1381,1291,1363307,14295
0h 19m 9s,14295,576,1148,1363883,14295
0h 19m 10s,14295,552,1029,1364435,14295
0h 19m 11s,14295,905,1004,1365340,14295
0h 19m 12s,14295,690,941,1366030,14295
0h 19m 13s,14295,0,753,1366030,14295
0h 19m 14s,14295,0,602,1366030,14295
0h 19m 15s,14295,2157,913,1368187,14295
0h 19m 16s,14295,1816,1094,1370003,14295
0h 19m 17s,14295,642,1004,1370645,14295
0h 19m 18s,14295,571,917,1371216,14295
0h 19m 19s,14295,734,880,1371950,14295
0h 19m 20s,14295,2112,1126,1374062,14295
0h 19m 21s,14295,0,901,1374062,14295
0h 19m 22s,14296,1346,990,1375408,14296
0h 19m 23s,14296,0,792,1375408,14296
0h 19m 24s,14296,3817,1397,1379225,14296
0h 19m 25s,14296,2616,1641,1381841,14296
0h 19m 26s,14296,0,1313,1381841,14296
0h 19m 27s,14296,2024,1455,1383865,14296
0h 19m 28s,14296,0,1164,1383865,14296
0h 19m 29s,14296,1245,1180,1385110,14296
0h 19m 30s,14296,1233,1191,1386343,14296
0h 19m 31s,14296,2260,1405,1388603,14296
0h 19m 32s,14296,576,1239,1389179,14296
0h 19m 33s,14296,1370,1265,1390549,14296
0h 19m 34s,14296,0,1012,1390549,14296
0h 19m 35s,14296,0,810,1390549,14296
0h 19m 36s,14296,1106,869,1391655,14296
0h 19m 37s,14296,1589,1013,1393244,14296
0h 19m 38s,14296,555,921,1393799,14296
0h 19m 39s,14296,1310,999,1395109,14296
0h 19m 40s,14302,1343,1068,1396452,14302
0h 19m 41s,14302,0,854,1396452,14302
0h 19m 42s,14302,1537,991,1397989,14302
0h 19m 43s,14302,1231,1039,1399220,14302
0h 19m 44s,14302,1310,1093,1400530,14302
0h 19m 45s,14302,1776,1230,1402306,14302
0h 19m 46s,14302,0,984,1402306,14302
0h 19m 47s,14302,1210,1029,1403516,14302
0h 19m 48s,14302,2747,1373,1406263,14302
0h 19m 49s,14302,832,1265,1407095,14302
0h 19m 50s,14302,0,1012,1407095,14302
0h 19m 51s,14302,3289,1467,1410384,14302
0h 19m 52s,14302,570,1288,1410954,14302
0h 19m 53s,14302,1868,1404,1412822,14302
0h 19m 54s,14302,1854,1494,1414676,14302
0h 19m 55s,14302,642,1324,1415318,14302
0h 19m 56s,14302,1845,1428,1417163,14302
0h 19m 57s,14302,1109,1364,1418272,14302
0h 19m 58s,14302,1602,1412,1419874,14302
0h 19m 59s,14302,793,1288,1420667,14302
0h 20m 0s,14302,1411,1313,1422078,14302
0h 20m 1s,14302,594,1169,1422672,14302
0h 20m 2s,14302,905,1116,1423577,14302
0h 20m 3s,14302,0,893,1423577,14302
0h 20m 4s,14302,1359,986,1424936,14302
0h 20m 5s,14302,1635,1116,1426571,14302
0h 20m 6s,14302,2234,1340,1428805,14302
0h 20m 7s,14302,0,1072,1428805,14302
0h 20m 8s,14302,1962,1250,1430767,14302
0h 20m 9s,14302,0,1000,1430767,14302
0h 20m 10s,14302,0,800,1430767,14302
0h 20m 11s,14302,2031,1046,1432798,14302
0h 20m 13s,14302,2548,1346,1435346,14302
0h 20m 14s,14302,0,1077,1435346,14302
0h 20m 15s,14302,1117,1085,1436463,14302
0h 20m 16s,14302,882,1044,1437345,14302
0h 20m 17s,14302,0,835,1437345,14302
0h 20m 18s,14302,2038,1076,1439383,14302
0h 20m 19s,14302,2308,1322,1441691,14302
0h 20m 20s,14302,783,1214,1442474,14302
0h 20m 21s,14302,2010,1373,1444484,14302
0h 20m 22s,14303,1246,1348,1445730,14303
0h 20m 23s,14303,647,1208,1446377,14303
0h 20m 24s,14303,2364,1439,1448741,14303
0h 20m 25s,14303,762,1304,1449503,14303
0h 20m 26s,14303,1788,1401,1451291,14303
0h 20m 27s,14303,2138,1548,1453429,14303
0h 20m 28s,14303,660,1370,1454089,14303
0h 20m 29s,14303,2310,1558,1456399,14303
0h 20m 30s,14303,0,1246,1456399,14303
0h 20m 31s,14303,428,1082,1456827,14303
0h 20m 32s,14303,1799,1225,1458626,14303
0h 20m 33s,14303,748,1130,1459374,14303
0h 20m 34s,14303,671,1038,1460045,14303
0h 20m 35s,14303,471,925,1460516,14303
0h 20m 36s,14303,2943,1329,1463459,14303
0h 20m 37s,14303,692,1202,1464151,14303
0h 20m 38s,14322,651,1092,1464802,14303
0h 20m 39s,14322,2366,1347,1467168,14322
0h 20m 40s,14322,0,1078,1467168,14322
0h 20m 41s,14322,2043,1271,1469211,14322
0h 20m 42s,14322,707,1158,1469918,14322
0h 20m 43s,14322,1167,1160,1471085,14322
0h 20m 44s,14322,2420,1412,1473505,14322
0h 20m 45s,14322,597,1249,1474102,14322
0h 20m 46s,14322,0,999,1474102,14322
0h 20m 47s,14322,1330,1065,1475432,14322
0h 20m 48s,14322,0,852,1475432,14322
0h 20m 49s,14322,1498,981,1476930,14322
0h 20m 50s,14322,2199,1225,1479129,14322
0h 20m 51s,14322,1146,1209,1480275,14322
0h 20m 52s,14322,0,967,1480275,14322
0h 20m 53s,14322,2604,1294,1482879,14322
0h 20m 54s,14322,1152,1266,1484031,14322
0h 20m 55s,14322,580,1129,1484611,14322
0h 20m 56s,14322,914,1086,1485525,14322
0h 20m 57s,14322,1424,1154,1486949,14322
0h 20m 58s,14323,1103,1144,1488052,14322
0h 20m 59s,14323,1163,1148,1489215,14323
0h 21m 0s,14323,1252,1169,1490467,14323
0h 21m 1s,14323,0,935,1490467,14323
0h 21m 2s,14323,1400,1028,1491867,14323
0h 21m 3s,14323,1210,1064,1493077,14323
0h 21m 4s,14323,583,968,1493660,14323
0h 21m 5s,14323,638,902,1494298,14323
0h 21m 6s,14323,1459,1013,1495757,14323
0h 21m 7s,14323,650,940,1496407,14323
0h 21m 8s,14323,1179,988,1497586,14323
0h 21m 9s,14323,2372,1265,1499958,14323
0h 21m 10s,14323,723,1157,1500681,14323
0h 21m 11s,14323,559,1037,1501240,14323
0h 21m 12s,14323,1864,1202,1503104,14323
0h 21m 13s,14323,626,1087,1503730,14323
0h 21m 14s,14323,1780,1226,1505510,14323
0h 21m 15s,14323,683,1117,1506193,14323
0h 21m 16s,14323,1860,1266,1508053,14323
0h 21m 17s,14323,393,1091,1508446,14323
0h 21m 18s,14323,1367,1146,1509813,14323
0h 21m 19s,14323,2170,1351,1511983,14323
0h 21m 20s,14323,0,1081,1511983,14323
0h 21m 21s,14323,0,865,1511983,14323
0h 21m 22s,14323,625,817,1512608,14323
0h 21m 23s,14323,1513,956,1514121,14323
0h 21m 24s,14323,4083,1581,1518204,14323
0h 21m 25s,14323,0,1265,1518204,14323
0h 21m 26s,14323,1689,1350,1519893,14323
0h 21m 27s,14323,570,1194,1520463,14323
0h 21m 28s,14323,1757,1307,1522220,14323
0h 21m 29s,14323,1946,1435,1524166,14323
0h 21m 30s,14323,1343,1417,1525509,14323
0h 21m 31s,14323,2410,1616,1527919,14323
0h 21m 32s,14323,743,1441,1528662,14323
0h 21m 33s,14323,0,1153,1528662,14323
0h 21m 34s,14323,1235,1169,1529897,14323
0h 21m 35s,14323,2198,1375,1532095,14323
0h 21m 36s,14323,1633,1427,1533728,14323
0h 21m 37s,14323,1216,1385,1534944,14323
0h 21m 38s,14323,496,1207,1535440,14323
0h 21m 39s,14323,0,966,1535440,14323
0h 21m 40s,14323,773,927,1536213,14323
0h 21m 41s,14323,1062,954,1537275,14323
0h 21m 42s,14323,2141,1191,1539416,14323
0h 21m 43s,14323,661,1085,1540077,14323
0h 21m 44s,14323,1155,1099,1541232,14323
0h 21m 45s,14323,1984,1276,1543216,14323
0h 21m 46s,14323,487,1118,1543703,14323
0h 21m 47s,14323,791,1053,1544494,14323
0h 21m 48s,14323,1599,1162,1546093,14323
0h 21m 49s,14323,3086,1547,1549179,14323
0h 21m 50s,14323,514,1340,1549693,14323
0h 21m 51s,14323,1326,1337,1551019,14323
0h 21m 52s,14323,0,1070,1551019,14323
0h 21m 53s,14323,1403,1137,1552422,14323
0h 21m 54s,14323,0,910,1552422,14323
0h 21m 55s,14323,0,728,1552422,14323
0h 21m 56s,14323,4129,1408,1556551,14323
0h 21m 57s,14323,0,1126,1556551,14323
0h 21m 58s,14323,1541,1209,1558092,14323
0h 21m 59s,14323,704,1108,1558796,14323
0h 22m 0s,14323,2551,1397,1561347,14323
0h 22m 1s,14323,1315,1381,1562662,14323
0h 22m 2s,14323,0,1105,1562662,14323
0h 22m 3s,14323,0,884,1562662,14323
0h 22m 4s,14323,2962,1300,1565624,14323
0h 22m 5s,14323,0,1040,1565624,14323
0h 22m 6s,14323,1918,1216,1567542,14323
0h 22m 7s,14323,3207,1614,1570749,14323
0h 22m 8s,14323,1769,1645,1572518,14323
0h 22m 9s,14323,0,1316,1572518,14323
0h 22m 10s,14323,653,1183,1573171,14323
0h 22m 11s,14323,2325,1411,1575496,14323
0h 22m 12s,14323,673,1263,1576169,14323
0h 22m 13s,14323,1767,1364,1577936,14323
0h 22m 14s,14323,634,1218,1578570,14323
0h 22m 15s,14323,1439,1262,1580009,14323
0h 22m 16s,14323,2677,1545,1582686,14323
0h 22m 17s,14323,1335,1503,1584021,14323
0h 22m 18s,14327,585,1319,1584606,14323
0h 22m 19s,14327,530,1161,1585136,14327
0h 22m 20s,14327,590,1047,1585726,14327
0h 22m 21s,14327,1873,1212,1587599,14327
0h 22m 22s,14327,0,970,1587599,14327
0h 22m 23s,14327,1315,1039,1588914,14327
0h 22m 24s,14327,1885,1208,1590799,14327
0h 22m 25s,14327,746,1116,1591545,14327
0h 22m 26s,14327,2206,1334,1593751,14327
0h 22m 27s,14327,2126,1492,1595877,14327
0h 22m 29s,14327,490,1292,1596367,14327
0h 22m 30s,14327,1870,1408,1598237,14327
0h 22m 31s,14327,1240,1374,1599477,14327
0h 22m 32s,14327,632,1226,1600109,14327
0h 22m 33s,14327,1218,1224,1601327,14327
0h 22m 34s,14327,1227,1225,1602554,14327
0h 22m 35s,14327,0,980,1602554,14327
0h 22m 36s,14327,1907,1165,1604461,14327
0h 22m 37s,14327,1985,1329,1606446,14327
0h 22m 38s,14327,1068,1277,1607514,14327
0h 22m 39s,14327,1749,1371,1609263,14327
0h 22m 40s,14327,663,1229,1609926,14327
0h 22m 41s,14327,658,1115,1610584,14327
0h 22m 42s,14327,526,997,1611110,14327
0h 22m 43s,14327,2072,1212,1613182,14327
0h 22m 44s,14327,1823,1334,1615005,14327
0h 22m 45s,14327,651,1197,1615656,14327
0h 22m 46s,14327,1337,1225,1616993,14327
0h 22m 47s,14327,529,1086,1617522,14327
0h 22m 48s,14327,1894,1248,1619416,14327
0h 22m 49s,14327,1608,1320,1621024,14327
0h 22m 50s,14327,1253,1307,1622277,14327
0h 22m 51s,14327,0,1046,1622277,14327
0h 22m 52s,14327,1806,1198,1624083,14327
0h 22m 53s,14327,1166,1192,1625249,14327
0h 22m 54s,14327,2284,1410,1627533,14327
0h 22m 55s,14327,0,1128,1627533,14327
0h 22m 56s,14327,1894,1281,1629427,14327
0h 22m 57s,14327,2366,1498,1631793,14327
0h 22m 58s,14327,0,1198,1631793,14327
0h 22m 59s,14327,1963,1351,1633756,14327
0h 23m 0s,14327,427,1166,1634183,14327
0h 23m 1s,14327,641,1061,1634824,14327
0h 23m 2s,14327,2155,1280,1636979,14327
0h 23m 3s,14327,1371,1298,1638350,14327
0h 23m 4s,14327,1184,1275,1639534,14327
0h 23m 5s,14327,573,1135,1640107,14327
0h 23m 6s,14327,1016,1111,1641123,14327
0h 23m 7s,14327,503,989,1641626,14327
0h 23m 8s,14327,2452,1282,1644078,14327
0h 23m 9s,14327,1328,1291,1645406,14327
0h 23m 10s,14327,1600,1353,1647006,14327
0h 23m 11s,14327,1287,1340,1648293,14327
0h 23m 12s,14327,598,1192,1648891,14327
0h 23m 13s,14327,1037,1161,1649928,14327
0h 23m 14s,14327,1165,1162,1651093,14327
0h 23m 15s,14327,688,1067,1651781,14327
0h 23m 16s,14327,479,949,1652260,14327
0h 23m 17s,14327,2005,1160,1654265,14327
0h 23m 18s,14327,3094,1547,1657359,14327
0h 23m 19s,14327,551,1348,1657910,14327
0h 23m 20s,14327,1312,1341,1659222,14327
0h 23m 21s,14327,2016,1476,1661238,14327
0h 23m 22s,14327,653,1311,1661891,14327
0h 23m 23s,14329,572,1163,1662463,14329
0h 23m 24s,14329,715,1073,1663178,14329
0h 23m 25s,14329,2843,1427,1666021,14329
0h 23m 26s,14329,2411,1624,1668432,14329
0h 23m 27s,14329,1284,1556,1669716,14329
0h 23m 28s,14329,0,1245,1669716,14329
0h 23m 29s,14329,1889,1374,1671605,14329
0h 23m 30s,14329,0,1099,1671605,14329
0h 23m 31s,14329,1443,1168,1673048,14329
0h 23m 32s,14329,2386,1412,1675434,14329
0h 23m 33s,14329,745,1279,1676179,14329
0h 23m 34s,14329,470,1117,1676649,14329
0h 23m 35s,14329,586,1011,1677235,14329
0h 23m 36s,14330,1249,1059,1678484,14329
0h 23m 37s,14330,875,1022,1679359,14330
0h 23m 38s,14330,0,818,1679359,14330
0h 23m 39s,14330,1191,893,1680550,14330
0h 23m 40s,14330,2538,1222,1683088,14330
0h 23m 41s,14330,491,1076,1683579,14330
0h 23m 42s,14330,1015,1064,1684594,14330
0h 23m 43s,14330,1783,1208,1686377,14330
0h 23m 44s,14330,1547,1276,1687924,14330
0h 23m 45s,14330,558,1132,1688482,14330
0h 23m 46s,14330,1876,1281,1690358,14330
0h 23m 47s,14330,1029,1231,1691387,14330
0h 23m 48s,14330,2011,1387,1693398,14330
0h 23m 49s,14330,516,1213,1693914,14330
0h 23m 50s,14330,1306,1232,1695220,14330
0h 23m 51s,14330,2326,1451,1697546,14330
0h 23m 52s,14330,691,1299,1698237,14330
0h 23m 53s,14330,0,1039,1698237,14330
0h 23m 54s,14330,1356,1102,1699593,14330
0h 23m 55s,14330,0,882,1699593,14330
0h 23m 56s,14330,1574,1020,1701167,14330
0h 23m 57s,14330,766,969,1701933,14330
0h 23m 58s,14330,0,775,1701933,14330
0h 23m 59s,14330,3605,1341,1705538,14330
0h 24m 0s,14330,475,1168,1706013,14330
0h 24m 1s,14330,1346,1204,1707359,14330
0h 24m 2s,14330,818,1127,1708177,14330
0h 24m 3s,14330,1333,1168,1709510,14330
0h 24m 4s,14330,1994,1333,1711504,14330
0h 24m 5s,14330,282,1123,1711786,14330
0h 24m 6s,14330,2071,1313,1713857,14330
0h 24m 7s,14330,0,1050,1713857,14330
0h 24m 8s,14330,2272,1294,1716129,14330
0h 24m 9s,14330,1572,1350,1717701,14330
0h 24m 10s,14330,595,1199,1718296,14330
0h 24m 11s,14330,2055,1370,1720351,14330
0h 24m 12s,14330,1177,1331,1721528,14330
0h 24m 13s,14330,1789,1423,1723317,14330
0h 24m 14s,14330,0,1138,1723317,14330
0h 24m 15s,14330,1613,1233,1724930,14330
0h 24m 16s,14330,1973,1381,1726903,14330
0h 24m 17s,14330,1285,1362,1728188,14330
0h 24m 18s,14330,689,1227,1728877,14330
0h 24m 19s,14330,1311,1244,1730188,14330
0h 24m 20s,14330,1035,1202,1731223,14330
0h 24m 21s,14330,0,962,1731223,14330
0h 24m 22s,14330,1453,1060,1732676,14330
0h 24m 23s,14330,1300,1108,1733976,14330
0h 24m 24s,14330,716,1030,1734692,14330
0h 24m 25s,14330,0,824,1734692,14330
0h 24m 26s,14330,0,659,1734692,14330
0h 24m 27s,14330,602,648,1735294,14330
0h 24m 28s,14330,1440,806,1736734,14330
0h 24m 29s,14330,624,770,1737358,14330
0h 24m 30s,14330,809,778,1738167,14330
0h 24m 31s,14330,2116,1046,1740283,14330
0h 24m 32s,14330,1493,1135,1741776,14330
0h 24m 33s,14330,2166,1341,1743942,14330
0h 24m 34s,14330,0,1073,1743942,14330
0h 24m 35s,14330,0,858,1743942,14330
0h 24m 36s,14330,1955,1077,1745897,14330
0h 24m 37s,14330,1292,1120,1747189,14330
0h 24m 38s,14330,2066,1309,1749255,14330
0h 24m 39s,14330,719,1191,1749974,14330
0h 24m 40s,14330,634,1080,1750608,14330
0h 24m 41s,14330,2233,1311,1752841,14330
0h 24m 42s,14330,1737,1396,1754578,14330
0h 24m 43s,14330,2569,1631,1757147,14330
0h 24m 44s,14330,584,1422,1757731,14330
0h 24m 45s,14330,2074,1552,1759805,14330
0h 24m 46s,14330,0,1242,1759805,14330
0h 24m 47s,14330,1021,1198,1760826,14330
0h 24m 48s,14330,522,1063,1761348,14330
0h 24m 50s,14330,544,959,1761892,14330
0h 24m 51s,14330,1225,1012,1763117,14330
0h 24m 52s,14330,1785,1167,1764902,14330
0h 24m 53s,14330,3201,1574,1768103,14330
0h 24m 54s,14330,0,1259,1768103,14330
0h 24m 55s,14330,0,1007,1768103,14330
0h 24m 56s,14330,3239,1453,1771342,14330
0h 24m 57s,14330,688,1300,1772030,14330
0h 24m 58s,14330,1350,1310,1773380,14330
0h 24m 59s,14330,1204,1289,1774584,14330
0h 25m 0s,14330,1793,1390,1776377,14330
0h 25m 1s,14330,880,1288,1777257,14330
0h 25m 2s,14330,705,1171,1777962,14330
0h 25m 3s,14330,1378,1212,1779340,14330
0h 25m 4s,14330,635,1097,1779975,14330
0h 25m 5s,14330,1350,1148,1781325,14330
0h 25m 6s,14330,699,1058,1782024,14330
0h 25m 7s,14330,1519,1150,1783543,14330
0h 25m 8s,14330,2052,1330,1785595,14330
0h 25m 9s,14330,2029,1470,1787624,14330
0h 25m 10s,14330,1352,1446,1788976,14330
0h 25m 11s,14330,0,1157,1788976,14330
0h 25m 12s,14330,541,1034,1789517,14330
0h 25m 13s,14330,617,951,1790134,14330
0h 25m 14s,14330,0,761,1790134,14330
0h 25m 15s,14330,2704,1150,1792838,14330
0h 25m 16s,14330,0,920,1792838,14330
0h 25m 17s,14330,2728,1282,1795566,14330
0h 25m 18s,14330,1168,1259,1796734,14330
0h 25m 19s,14330,1834,1374,1798568,14330
0h 25m 20s,14330,1985,1496,1800553,14330
0h 25m 21s,14330,517,1300,1801070,14330
0h 25m 22s,14330,2759,1592,1803829,14330
0h 25m 23s,14330,507,1375,1804336,14330
0h 25m 24s,14330,2369,1574,1806705,14330
0h 25m 25s,14330,1114,1482,1807819,14330
0h 25m 26s,14330,0,1186,1807819,14330
0h 25m 27s,14330,1205,1190,1809024,14330
0h 25m 28s,14340,809,1114,1809833,14340
0h 25m 29s,14340,1942,1280,1811775,14340
0h 25m 30s,14340,2226,1469,1814001,14340
0h 25m 31s,14340,2011,1577,1816012,14340
0h 25m 32s,14340,0,1262,1816012,14340
0h 25m 33s,14340,0,1010,1816012,14340
0h 25m 34s,14340,1268,1062,1817280,14340
0h 25m 35s,14340,779,1005,1818059,14340
0h 25m 36s,14340,1045,1013,1819104,14340
0h 25m 37s,14340,979,1006,1820083,14340
0h 25m 38s,14340,584,922,1820667,14340
0h 25m 39s,14340,699,877,1821366,14340
0h 25m 40s,14340,2636,1229,1824002,14340
0h 25m 41s,14340,1420,1267,1825422,14340
0h 25m 42s,14342,1275,1269,1826697,14340
0h 25m 43s,14342,1157,1247,1827854,14342
0h 25m 44s,14342,1841,1366,1829695,14342
0h 25m 45s,14342,798,1252,1830493,14342
0h 25m 46s,14342,3200,1642,1833693,14342
0h 25m 47s,14342,0,1314,1833693,14342
0h 25m 48s,14342,675,1186,1834368,14342
0h 25m 49s,14342,2541,1457,1836909,14342
0h 25m 50s,14342,0,1166,1836909,14342
0h 25m 51s,14342,1913,1315,1838822,14342
0h 25m 52s,14342,1419,1336,1840241,14342
0h 25m 53s,14342,0,1069,1840241,14342
0h 25m 54s,14342,0,855,1840241,14342
0h 25m 55s,14342,2169,1118,1842410,14342
0h 25m 56s,14342,2291,1353,1844701,14342
0h 25m 57s,14342,2151,1513,1846852,14342
0h 25m 58s,14342,2409,1692,1849261,14342
0h 25m 59s,14342,0,1354,1849261,14342
0h 26m 0s,14342,654,1214,1849915,14342
0h 26m 1s,14342,629,1097,1850544,14342
0h 26m 2s,14342,1985,1275,1852529,14342
0h 26m 3s,14342,3646,1749,1856175,14342
0h 26m 4s,14342,702,1540,1856877,14342
0h 26m 5s,14342,1103,1453,1857980,14342
0h 26m 6s,14342,0,1162,1857980,14342
0h 26m 7s,14342,1549,1239,1859529,14342
0h 26m 8s,14342,0,991,1859529,14342
0h 26m 9s,14342,555,904,1860084,14342
0h 26m 10s,14342,1296,982,1861380,14342
0h 26m 11s,14342,2514,1288,1863894,14342
0h 26m 12s,14342,607,1152,1864501,14342
0h 26m 13s,14342,1804,1282,1866305,14342
0h 26m 14s,14342,701,1166,1867006,14342
0h 26m 15s,14342,1450,1223,1868456,14342
0h 26m 16s,14342,1267,1232,1869723,14342
0h 26m 17s,14342,0,986,1869723,14342
0h 26m 18s,14342,1406,1070,1871129,14342
0h 26m 19s,14342,0,856,1871129,14342
0h 26m 20s,14342,617,808,1871746,14342
0h 26m 21s,14342,2480,1142,1874226,14342
0h 26m 22s,14342,1898,1293,1876124,14342
0h 26m 23s,14342,0,1034,1876124,14342
0h 26m 24s,14342,1299,1087,1877423,14342
0h 26m 25s,14342,1368,1143,1878791,14342
0h 26m 26s,14342,1430,1200,1880221,14342
0h 26m 27s,14342,0,960,1880221,14342
0h 26m 28s,14342,1143,997,1881364,14342
0h 26m 29s,14342,2095,1217,1883459,14342
0h 26m 30s,14342,1666,1307,1885125,14342
0h 26m 31s,14345,623,1170,1885748,14342
0h 26m 32s,14345,556,1047,1886304,14345
0h 26m 33s,14345,2405,1319,1888709,14345
0h 26m 34s,14345,0,1055,1888709,14345
0h 26m 35s,14345,0,844,1888709,14345
0h 26m 36s,14345,2156,1106,1890865,14345
0h 26m 37s,14345,3471,1579,1894336,14345
0h 26m 38s,14345,657,1395,1894993,14345
0h 26m 39s,14345,1924,1501,1896917,14345
0h 26m 40s,14345,1135,1428,1898052,14345
0h 26m 41s,14345,1274,1397,1899326,14345
0h 26m 42s,14345,932,1304,1900258,14345
0h 26m 43s,14345,2198,1483,1902456,14345
0h 26m 44s,14345,585,1303,1903041,14345
0h 26m 45s,14345,1018,1246,1904059,14345
0h 26m 46s,14347,2931,1583,1906990,14345
0h 26m 47s,14347,0,1266,1906990,14345
0h 26m 48s,14347,1194,1252,1908184,14347
0h 26m 49s,14347,512,1104,1908696,14347
0h 26m 50s,14347,597,1003,1909293,14347
0h 26m 51s,14347,1328,1068,1910621,14347
0h 26m 52s,14347,0,854,1910621,14347
0h 26m 53s,14347,1110,905,1911731,14347
0h 26m 54s,14347,1503,1025,1913234,14347
0h 26m 55s,14347,637,947,1913871,14347
0h 26m 56s,14347,521,862,1914392,14347
0h 26m 57s,14347,1541,998,1915933,14347
0h 26m 58s,14347,541,907,1916474,14347
0h 26m 59s,14347,860,898,1917334,14347
0h 27m 1s,14347,2422,1203,1919756,14347
0h 27m 2s,14347,609,1084,1920365,14347
0h 27m 3s,14347,513,970,1920878,14347
0h 27m 4s,14347,1993,1175,1922871,14347
0h 27m 5s,14347,2083,1357,1924954,14347
0h 27m 6s,14347,0,1086,1924954,14347
0h 27m 7s,14347,634,996,1925588,14347
0h 27m 8s,14347,2066,1210,1927654,14347
0h 27m 9s,14347,2248,1418,1929902,14347
0h 27m 10s,14347,573,1249,1930475,14347
0h 27m 11s,14347,1369,1273,1931844,14347
0h 27m 12s,14347,1014,1221,1932858,14347
0h 27m 13s,14347,2108,1398,1934966,14347
0h 27m 14s,14347,1631,1445,1936597,14347
0h 27m 15s,14347,1472,1450,1938069,14347
0h 27m 16s,14347,660,1292,1938729,14347
0h 27m 17s,14347,0,1034,1938729,14347
0h 27m 18s,14347,708,969,1939437,14347
0h 27m 19s,14347,0,775,1939437,14347
0h 27m 20s,14347,1321,884,1940758,14347
0h 27m 21s,14347,0,707,1940758,14347
0h 27m 22s,14347,1796,925,1942554,14347
0h 27m 23s,14347,1533,1047,1944087,14347
0h 27m 24s,14347,0,838,1944087,14347
0h 27m 25s,14347,2177,1106,1946264,14347
0h 27m 26s,14347,573,999,1946837,14347
0h 27m 27s,14347,0,799,1946837,14347
0h 27m 28s,14347,1269,893,1948106,14347
0h 27m 29s,14347,1314,977,1949420,14347
0h 27m 30s,14347,0,782,1949420,14347
0h 27m 31s,14347,2135,1053,1951555,14347
0h 27m 32s,14347,672,977,1952227,14347
0h 27m 33s,14347,552,892,1952779,14347
0h 27m 34s,14347,1459,1005,1954238,14347
0h 27m 35s,14347,2816,1367,1957054,14347
0h 27m 36s,14347,1104,1314,1958158,14347
0h 27m 37s,14347,510,1153,1958668,14347
0h 27m 38s,14347,2515,1425,1961183,14347
0h 27m 39s,14347,2640,1668,1963823,14347
0h 27m 40s,14347,1564,1647,1965387,14347
0h 27m 41s,14347,2978,1913,1968365,14347
0h 27m 42s,14347,0,1530,1968365,14347
0h 27m 43s,14347,749,1374,1969114,14347
0h 27m 44s,14347,1335,1366,1970449,14347
0h 27m 45s,14347,2419,1577,1972868,14347
0h 27m 46s,14347,710,1404,1973578,14347
0h 27m 47s,14347,2117,1547,1975695,14347
0h 27m 48s,14347,1286,1495,1976981,14347
0h 27m 49s,14347,0,1196,1976981,14347
0h 27m 50s,14347,1100,1177,1978081,14347
0h 27m 51s,14347,0,942,1978081,14347
0h 27m 52s,14347,0,754,1978081,14347
0h 27m 53s,14347,796,762,1978877,14347
0h 27m 54s,14347,844,778,1979721,14347
0h 27m 55s,14347,539,730,1980260,14347
0h 27m 56s,14347,841,752,1981101,14347
0h 27m 57s,14347,773,756,1981874,14347
0h 27m 58s,14347,2760,1157,1984634,14347
0h 27m 59s,14347,1455,1217,1986089,14347
0h 28m 0s,14347,749,1123,1986838,14347
0h 28m 1s,14347,567,1012,1987405,14347
0h 28m 2s,14347,530,916,1987935,14347
0h 28m 3s,14347,1886,1110,1989821,14347
0h 28m 4s,14347,626,1013,1990447,14347
0h 28m 5s,14347,1527,1116,1991974,14347
0h 28m 6s,14347,1630,1219,1993604,14347
0h 28m 7s,14347,2663,1508,1996267,14347
0h 28m 8s,14347,1083,1423,1997350,14347
0h 28m 9s,14347,508,1240,1997858,14347
0h 28m 10s,14347,1509,1294,1999367,14347
0h 28m 11s,14347,492,1134,1999859,14347
0h 28m 12s,14347,2109,1329,2001968,14347
0h 28m 13s,14347,2036,1470,2004004,14347
0h 28m 14s,14347,0,1176,2004004,14347
0h 28m 15s,14347,1366,1214,2005370,14347
0h 28m 16s,14347,581,1087,2005951,14347
0h 28m 17s,14347,1456,1161,2007407,14347
0h 28m 18s,14347,0,929,2007407,14347
0h 28m 19s,14347,721,887,2008128,14347
0h 28m 20s,14347,1330,976,2009458,14347
0h 28m 21s,14347,718,924,2010176,14347
0h 28m 22s,14347,3244,1388,2013420,14347
0h 28m 23s,14347,383,1187,2013803,14347
0h 28m 24s,14347,490,1048,2014293,14347
0h 28m 25s,14347,1638,1166,2015931,14347
0h 28m 26s,14347,0,933,2015931,14347
0h 28m 27s,14347,1157,978,2017088,14347
0h 28m 28s,14347,3757,1534,2020845,14347
0h 28m 29s,14347,2125,1652,2022970,14347
0h 28m 30s,14347,0,1322,2022970,14347
0h 28m 31s,14347,1937,1445,2024907,14347
0h 28m 32s,14347,1253,1407,2026160,14347
0h 28m 33s,14347,1416,1409,2027576,14347
0h 28m 34s,14347,682,1264,2028258,14347
0h 28m 35s,14347,1213,1254,2029471,14347
0h 28m 36s,14347,1320,1267,2030791,14347
0h 28m 37s,14347,1579,1329,2032370,14347
0h 28m 38s,14347,1512,1366,2033882,14347
0h 28m 39s,14347,774,1248,2034656,14347
0h 28m 40s,14347,1348,1268,2036004,14347
0h 28m 41s,14347,1361,1287,2037365,14347
0h 28m 42s,14347,597,1149,2037962,14347
0h 28m 43s,14347,582,1036,2038544,14347
0h 28m 44s,14347,610,951,2039154,14347
0h 28m 45s,14347,1236,1008,2040390,14347
0h 28m 46s,14347,0,806,2040390,14347
0h 28m 47s,14347,1339,913,2041729,14347
0h 28m 48s,14347,1242,979,2042971,14347
0h 28m 49s,14347,2753,1334,2045724,14347
0h 28m 50s,14347,759,1219,2046483,14347
0h 28m 51s,14347,0,975,2046483,14347
0h 28m 52s,14347,490,878,2046973,14347
0h 28m 53s,14347,0,702,2046973,14347
0h 28m 54s,14347,1233,808,2048206,14347
0h 28m 55s,14347,3576,1362,2051782,14347
0h 28m 56s,14347,698,1229,2052480,14347
0h 28m 57s,14347,657,1115,2053137,14347
0h 28m 58s,14347,2170,1326,2055307,14347
0h 28m 59s,14347,2649,1591,2057956,14347
0h 29m 0s,14347,1205,1514,2059161,14347
0h 29m 1s,14347,1179,1447,2060340,14347
0h 29m 2s,14347,1526,1463,2061866,14347
0h 29m 3s,14347,622,1295,2062488,14347
0h 29m 4s,14347,2406,1517,2064894,14347
0h 29m 5s,14347,707,1355,2065601,14347
0h 29m 6s,14347,556,1195,2066157,14347
0h 29m 7s,14347,712,1098,2066869,14347
0h 29m 9s,14347,899,1058,2067768,14347
0h 29m 10s,14347,2007,1248,2069775,14347
0h 29m 11s,14347,0,998,2069775,14347
0h 29m 12s,14347,0,798,2069775,14347
0h 29m 13s,14605,739,786,2070514,14605
0h 29m 14s,14605,1481,925,2071995,14605
0h 29m 15s,14605,1371,1014,2073366,14605
0h 29m 16s,14605,601,931,2073967,14605
0h 29m 17s,14605,477,840,2074444,14605
0h 29m 18s,14605,540,780,2074984,14605
0h 29m 19s,14605,0,624,2074984,14605
0h 29m 20s,14605,2527,1005,2077511,14605
0h 29m 21s,14605,2809,1366,2080320,14605
0h 29m 22s,14605,1479,1389,2081799,14605
0h 29m 23s,14605,1275,1366,2083074,14605
0h 29m 24s,14605,1343,1361,2084417,14605
0h 29m 25s,14605,1245,1338,2085662,14605
0h 29m 26s,14605,1937,1458,2087599,14605
0h 29m 27s,14605,725,1311,2088324,14605
0h 29m 28s,14605,1418,1332,2089742,14605
0h 29m 29s,14609,1337,1333,2091079,14609
0h 29m 30s,14609,1276,1322,2092355,14609
0h 29m 31s,14609,0,1058,2092355,14609
0h 29m 32s,14609,663,979,2093018,14609
0h 29m 33s,14609,1278,1039,2094296,14609
0h 29m 34s,14683,0,831,2094296,14609
0h 29m 35s,14683,1389,943,2095685,14683
0h 29m 36s,14683,2500,1254,2098185,14683
0h 29m 37s,14683,599,1123,2098784,14683
0h 29m 38s,14683,737,1046,2099521,14683
0h 29m 39s,14683,1427,1122,2100948,14683
0h 29m 40s,14683,749,1047,2101697,14683
0h 29m 41s,14683,1201,1078,2102898,14683
0h 29m 42s,14683,1939,1250,2104837,14683
0h 29m 43s,14683,1274,1255,2106111,14683
0h 29m 44s,14683,451,1094,2106562,14683
0h 29m 45s,14683,2379,1351,2108941,14683
0h 29m 46s,14683,1915,1464,2110856,14683
0h 29m 47s,14683,1671,1505,2112527,14683
0h 29m 48s,14683,1197,1443,2113724,14683
0h 29m 49s,14683,0,1154,2113724,14683
0h 29m 50s,14683,1728,1269,2115452,14683
0h 29m 51s,14683,1892,1394,2117344,14683
0h 29m 52s,14683,1074,1330,2118418,14683
0h 29m 53s,14683,0,1064,2118418,14683
0h 29m 54s,14683,1939,1239,2120357,14683
0h 29m 55s,14683,587,1109,2120944,14683
0h 29m 56s,14683,1309,1149,2122253,14683
0h 29m 57s,14683,2023,1324,2124276,14683
0h 29m 58s,14683,619,1183,2124895,14683
0h 29m 59s,14683,1056,1158,2125951,14683
